Word	Reading	JLPT	Meaning
ああ	ああ	JLPT N4	[Adverb] 1. like that (used for something or someone distant from both speaker and listener); so {See also 斯う, See also 然う, See also 如何 どう}
間	あいだ	JLPT N4	[Adverbial noun, Noun] 1. space (between); gap; interval; distance [Adverbial noun, Temporal noun] 2. time (between); pause; break [Adverbial noun, Noun, Temporal noun] 3. span (temporal or spatial); stretch; period (while) [Adverbial noun, Noun] 4. relationship (between, among) 5. members (within, among) [Conjunction] 6. due to; because of {Archaism, Only applies to あいだ} | Other forms: 間 【あわい】 [Notes] あわい: Out-dated or obsolete kana usage.
合う	あう	JLPT N4	[Godan verb with u ending, intransitive verb] 1. to come together; to merge; to unite; to meet 2. to fit; to match; to suit; to agree with; to be correct 3. to be profitable; to be equitable [Suffix, Godan verb with u ending] 4. to do ... to each other; to do ... together {after the -masu stem of a verb} | Other forms: 合う 【おう】 [Notes] おう: Irregular kana usage.
赤ちゃん	あかちゃん	JLPT N4	[Noun] 1. baby; infant
上がる	あがる	JLPT N4	[Godan verb with ru ending, intransitive verb] 1. to rise; to go up; to come up; to ascend; to be raised {Antonym: 下がる} 2. to enter (esp. from outdoors); to come in; to go in 3. to enter (a school); to advance to the next grade 4. to get out (of water); to come ashore 5. to increase {also written as 騰る in ref. to price} 6. to improve; to make progress 7. to be promoted; to advance 8. to be made (of profit, etc.) 9. to occur (esp. of a favourable result) 10. to be adequate (to cover expenses, etc.) {often as 〜で上がる} 11. to be finished; to be done; to be over 12. (of rain) to stop; to lift 13. to stop (working properly); to cut out; to give out; to die 14. to win (in a card game, etc.) 15. to be arrested {Only applies to 挙がる} 16. to turn up (of evidence, etc.) {Only applies to 挙がる} 17. to be deep fried {Only applies to 揚がる} 18. to be spoken loudly 19. to get stage fright 20. to be offered (to the gods, etc.) 21. to go; to visit {Humble (kenjougo)} 22. to eat; to drink {Honorific or respectful (sonkeigo)} 23. to be listed (as a candidate) {esp. 挙がる} 24. to serve (in one's master's home) 25. to go north {in Kyoto} [Suffix, Godan verb with ru ending] 26. indicates completion {See also 出来上がる, after the -masu stem of a verb} | Other forms: 揚がる 【あがる】、挙がる 【あがる】、上る 【あがる】 [Notes] 上る: Irregular okurigana usage.
赤ん坊	あかんぼう	JLPT N4	[Noun] 1. baby; infant | Other forms: 赤ん坊 【あかんぼ】
開く	あく	JLPT N5	[Godan verb with ku ending, intransitive verb] 1. to open (e.g. doors) {esp. 開く} 2. to open (e.g. business, etc.) {esp. 開く} 3. to be empty {esp. 空く} 4. to be vacant; to be available; to be free {esp. 空く} 5. to be open (e.g. neckline, etc.) {esp. 明く} 6. to have been opened (of one's eyes, mouth, etc.) {esp. 明く} 7. to come to an end {esp. 明く} [Godan verb with ku ending, Transitive verb] 8. to open (one's eyes, mouth, etc.) {esp. 明く} [Godan verb with ku ending, intransitive verb] 9. to have a hole; to form a gap; to have an interval (between events) {See also 穴が開く} | Other forms: 空く 【あく】、明く 【あく】 [Notes] あく: ichi1, spec1. 開く: spec1. あく: ichi1, spec1. 空く: ichi1. あく: ichi1, spec1.
アクセサリー	アクセサリー	JLPT N4	[Noun] 1. accessory [Wikipedia definition] 2. Accessory | Other forms: アクセサリ
上げる	あげる	JLPT N5	[Ichidan verb, Transitive verb] 1. to raise; to elevate {See also 手を挙げる} 2. to do up (one's hair) {See also 髪を上げる} 3. to fly (a kite, etc.); to launch (fireworks, etc.); to surface (a submarine, etc.) 4. to land (a boat) 5. to deep-fry {Only applies to 揚げる} 6. to show someone (into a room) 7. to summon (for geishas, etc.) {Usually written using kana alone, Only applies to 揚げる} 8. to send someone (away) 9. to enrol (one's child in school); to enroll 10. to increase (price, quality, status, etc.); to develop (talent, skill); to improve 11. to make (a loud sound); to raise (one's voice) {See also 声を上げる} 12. to earn (something desirable) 13. to praise 14. to give (an example, etc.); to cite {usu. 挙げる} 15. to summon up (all of one's energy, etc.) {usu. 挙げる} 16. to arrest {Only applies to 挙げる} 17. to nominate {Only applies to 挙げる} 18. to give {Polite (teineigo)} 19. to offer up (incense, a prayer, etc.) to the gods (or Buddha, etc.) 20. to bear (a child) 21. to conduct (a ceremony, esp. a wedding) {usu. 挙げる} [Ichidan verb, intransitive verb] 22. (of the tide) to come in [Ichidan verb, intransitive verb, Transitive verb] 23. to vomit [Auxiliary verb, Ichidan verb] 24. to do for (the sake of someone else) {Usually written using kana alone, Polite (teineigo), after the -te form of a verb} 25. to complete ... {See also 作り上げる, after the -masu stem of a verb} 26. to humbly do ... {Humble (kenjougo), See also 申し上げる, after the -masu stem of a humble verb to increase the level of humility} | Other forms: 挙げる 【あげる】、揚げる 【あげる】
浅い	あさい	JLPT N4	[I-adjective] 1. shallow; superficial {Antonym: 深い} 2. slight (wound); light (sleep); pale (colour); inadequate (knowledge) 3. short (time); early; young
味	あじ	JLPT N4	[Na-adjective, Noun] 1. flavor; flavour; taste 2. charm; style 3. experience [Na-adjective] 4. smart; clever; witty; strange {See also 味な}
アジア	アジア	JLPT N4	[Noun] 1. Asia (esp. "the Far East") {Usually written using kana alone} [No-adjective] 2. Asian; Asiatic | Other forms: 亜細亜 【あじあ】
明日	あした	JLPT N5	[Temporal noun] 1. tomorrow 2. near future {Only applies to あす} | Other forms: 明日 【あす】、明日 【みょうにち】
遊び	あそび	JLPT N4	[Noun, Noun - used as a suffix] 1. playing 2. play (margin between on and off, gap before pressing button or lever has an effect) {Usually written using kana alone}
あっ	あっ	JLPT N4	1. Ah!; Oh!; expression of surprise, recollection, etc. 2. Hey!; used to get someone's attention | Other forms: アッ、アっ、あ、ア [Notes] アっ: Irregular kana usage.
集まる	あつまる	JLPT N4	[Godan verb with ru ending, intransitive verb] 1. to gather; to collect; to assemble | Other forms: 集る 【あつまる】 [Notes] 集る: Irregular okurigana usage.
集める	あつめる	JLPT N4	[Ichidan verb, Transitive verb] 1. to collect; to assemble; to gather
アナウンサー	アナウンサー	JLPT N4	[Noun] 1. announcer | Other forms: アナウンサ [Notes] アナウンサー: gai1, ichi1.
阿弗利加	アフリカ	JLPT N4	[Noun, No-adjective] 1. Africa {Usually written using kana alone} | Other forms: 亜弗利加 【アフリカ】 [Notes] 阿弗利加: Ateji (phonetic) reading. 亜弗利加: Ateji (phonetic) reading.
亜米利加	アメリカ	JLPT N4	[Noun] 1. America {Usually written using kana alone} 2. United States of America {Usually written using kana alone} [Place] 3. America | Other forms: 亜墨利加 【アメリカ】 [Notes] 亜米利加: Ateji (phonetic) reading. 亜墨利加: Ateji (phonetic) reading.
謝る	あやまる	JLPT N4	[Godan verb with ru ending] 1. to apologize; to apologise
アルコール	アルコール	JLPT N4	[Noun, No-adjective] 1. alcohol | Other forms: アルコホル
アルバイト	アルバイト	JLPT N4	[Noun, Suru verb] 1. part-time job; side job {See also パート, See also パートタイム, From German “Arbeit”} [Noun] 2. albite {See also 曹長石}
安心	あんしん	JLPT N4	[Na-adjective, Noun, Suru verb] 1. relief; peace of mind | Other forms: 安神 【あんしん】
安全	あんぜん	JLPT N4	[Na-adjective, Noun] 1. safety {Antonym: 危険} 2. security
あんな	あんな	JLPT N4	[Pre-noun adjectival] 1. such (about something or someone distant from both speaker and listener, or about a situation unfamiliar to both speaker and listener); so; that; sort of {See also こんな, See also そんな, See also どんな}
以下	いか	JLPT N4	[Noun] 1. not exceeding; and downward; ... and below 2. below (e.g. standard); under (e.g. a level) 3. the below-mentioned; the following; the rest | Other forms: 以下 【いげ】、已下 【いか】、已下 【いげ】
以外	いがい	JLPT N4	[Adverbial noun] 1. with the exception of; excepting
医学	いがく	JLPT N4	[Noun] 1. medical science; medicine
生きる	いきる	JLPT N4	[Ichidan verb, intransitive verb] 1. to live; to exist 2. to make a living; to subsist 3. to be in effect; to be in use; to function 4. to come to life; to be enlivened 5. to be safe (in baseball, go, etc.) | Other forms: 活きる 【いきる】
意見	いけん	JLPT N4	[Noun, Suru verb, No-adjective] 1. opinion; view; comment
石	いし	JLPT N4	[Noun] 1. stone 2. gem; jewel
苛める	いじめる	JLPT N4	[Ichidan verb, Transitive verb] 1. to tease; to torment; to persecute; to chastise {Usually written using kana alone} | Other forms: 虐める 【いじめる】
以上	いじょう	JLPT N4	[Adverbial noun, Temporal noun] 1. not less than; ... and more; ... and upwards {See also 余} 2. beyond ... (e.g. one's means); further (e.g. nothing further to say); more than ... (e.g. cannot pay more than that) 3. above-mentioned; foregoing 4. since ...; seeing that ... 5. this is all; that is the end; the end | Other forms: 已上 【いじょう】
急ぐ	いそぐ	JLPT N4	[Godan verb with gu ending, intransitive verb, Transitive verb] 1. to hurry; to rush; to hasten; to make something happen sooner
致す	いたす	JLPT N4	[Godan verb with su ending, Transitive verb] 1. to do {Humble (kenjougo), Usually written using kana alone}
一度	いちど	JLPT N4	[Adverbial noun] 1. once; one time; on one occasion 2. temporarily; for a moment {Only applies to ひとたび} 3. one degree; one tone; one musical interval {Only applies to いちど} | Other forms: １度 【いちど】、一度 【ひとたび】、１度 【ひとたび】、一たび 【ひとたび】、ひと度 【ひとたび】、一とたび 【ひとたび】 [Notes] いちど: news1, nf03. 一度: news1, nf03. いちど: news1, nf03. 一度: news1, nf03. 一とたび: Irregular okurigana usage.
一生懸命	いっしょうけんめい	JLPT N4	[Na-adjective, Adverbial noun, Noun] 1. very hard; with utmost effort; with all one's might; for dear life {, See also 一所懸命} | Other forms: 一生けん命 【いっしょうけんめい】
一杯	いっぱい	JLPT N4	[Na-adjective, Adverb, Noun, No-adjective] 1. amount necessary to fill a container (e.g. cupful, spoonful, etc.); drink (usu. alcoholic) 2. full 3. one squid, octopus, crab, etc.; one boat [Adverb, No-adjective, Na-adjective] 4. fully; to capacity {Usually written using kana alone} 5. a lot; much {Usually written using kana alone} [Noun - used as a suffix, Adverbial noun] 6. all of ...; the entire ... {Usually written using kana alone} [Place] 7. Ippai | Other forms: １杯 【いっぱい】、一盃 【いっぱい】 [Notes] 一盃: Out-dated kanji.
糸	いと	JLPT N4	[Noun, Noun - used as a suffix] 1. thread; yarn; string
以内	いない	JLPT N4	[Noun, Noun - used as a suffix] 1. within; inside of; less than
田舎	いなか	JLPT N4	[Noun, No-adjective] 1. rural area; countryside; the sticks {Sensitive} 2. hometown [Notes] いなか: Gikun (meaning as reading) or jukujikun (special kanji reading).
祈る	いのる	JLPT N4	[Godan verb with ru ending, Transitive verb] 1. to pray; to wish | Other forms: 祷る 【いのる】
いらっしゃる	いらっしゃる	JLPT N4	[Godan verb - aru special class, intransitive verb] 1. to come; to go; to be (somewhere) {Honorific or respectful (sonkeigo), sometimes erroneously written 居らっしゃる} [Godan verb - aru special class, Auxiliary verb] 2. is (doing); are (doing) {Honorific or respectful (sonkeigo), after a -te form, or the particle "de"}
植える	うえる	JLPT N4	[Ichidan verb, Transitive verb] 1. to plant; to grow; to raise 2. to insert; to transplant; to implant; to set (type) 3. to inoculate (e.g. an infectious agent) 4. to instill (idea, value, etc.); to instil; to inculcate
受付	うけつけ	JLPT N4	[Noun] 1. reception (desk); information desk {esp. 受付} [Noun, Suru verb] 2. receipt; acceptance {See also 受け付ける} | Other forms: 受け付け 【うけつけ】、受付け 【うけつけ】、受け付 【うけつけ】
受ける	うける	JLPT N4	[Ichidan verb, Transitive verb] 1. to receive; to get 2. to catch (e.g. a ball) 3. to be struck by (wind, waves, sunlight, etc.) 4. to sustain (damage); to incur (a loss); to suffer (an injury); to feel (influence) 5. to undergo (e.g. surgery); to take (a test); to accept (a challenge) 6. to be given (e.g. life, talent) {esp. 受ける, 享ける} 7. to follow; to succeed; to be descended from {esp. 受ける, 享ける} 8. to face (south, etc.) 9. to be modified by {linguistics terminology, esp. 受ける, 承ける} 10. to obtain (a pawned item, etc.) by paying a fee {See also 請け出す, esp. 請ける, now primarily used in compound words} [Ichidan verb, intransitive verb] 11. to be well-received; to become popular; to go down well {Usually written using kana alone, esp. ウケる, うける} 12. to be funny; to be humorous {Colloquialism, Usually written using kana alone, esp. ウケる} | Other forms: 請ける 【うける】、承ける 【うける】、享ける 【うける】、ウケる
動く	うごく	JLPT N4	[Godan verb with ku ending, intransitive verb] 1. to move; to stir; to shift; to shake; to swing 2. to operate; to run; to go; to work 3. to be touched; to be influenced 4. to change; to vary; to fluctuate; to waver 5. certain; factual {as 動かぬ, 動かない, etc.} 6. to be transferred
内	うち	JLPT N4	[Noun, No-adjective] 1. inside; within 2. while {Usually written using kana alone, See also ないうちに, also 裡} 3. among; amongst; between {Usually written using kana alone} [Pronoun, No-adjective] 4. we (referring to one's in-group, e.g. company, etc.); our {Usually written using kana alone, See also 家 うち} 5. my spouse [Noun] 6. imperial palace grounds {Archaism} 7. emperor {Archaism} [Pronoun, No-adjective] 8. I (primarily used by women and children); me {Kansai dialect} | Other forms: 中 【うち】
打つ	うつ	JLPT N4	[Godan verb with tsu ending, Transitive verb] 1. to hit; to strike; to knock; to beat; to punch; to slap; to tap; to bang; to clap; to pound {also written as 拍つ, 搏つ, 撲つ, 擣つ} 2. to strike (noon, etc.); to sound (cymbals, etc.); to beat (a drum, etc.) 3. to beat (rhythmically, e.g. pulse, waves, etc.) 4. to move; to impress; to touch 5. to drive in; to hammer in; to put in; to inject 6. to type; to send; to transmit 7. to insert; to write in; to mark 8. to make (noodles, etc.); to prepare 9. to till (soil) 10. to sprinkle; to throw; to cast 11. to do; to carry out; to play; to perform; to engage in (gambling, etc.) 12. to pay (a deposit, etc.) 13. to visit (on a pilgrimage) 14. to line (a coat) 15. to bind (a criminal)
美しい	うつくしい	JLPT N4	[I-adjective] 1. beautiful; lovely
写す	うつす	JLPT N4	[Godan verb with su ending, Transitive verb] 1. to transcribe; to duplicate; to reproduce; to imitate; to trace 2. to describe 3. to film; to picture; to photograph
移る	うつる	JLPT N4	[Godan verb with ru ending, intransitive verb] 1. to move (house); to transfer (department) 2. to change the target of interest or concern 3. to elapse (passage of time) 4. to be permeated by a colour or scent 5. to be infected; to be contagious; to spread (as in fire) {Usually written using kana alone} | Other forms: 遷る 【うつる】
腕	うで	JLPT N4	[Noun] 1. arm 2. skill; efforts; ability [Place] 3. Ude
裏	うら	JLPT N4	[Noun] 1. bottom (or another side that is hidden from view); undersurface; opposite side; reverse side {Antonym: 表 おもて} 2. rear; back; behind (the house) 3. lining; inside 4. out of sight; behind the scenes; in the shadows 5. proof {See also 裏付け} 6. opposite (of a prediction, common sense, etc.) {See also 裏をかく} 7. inverse (of a hypothesis, etc.) 8. bottom (of an inning); last half (of an inning) {Baseball term, Antonym: 表 おもて}
売り場	うりば	JLPT N4	[Noun, No-adjective] 1. place where things are sold; point of sale; POS; sales floor; counter (in shop) [Noun] 2. favorable time to sell; good time to sell {See also 売り時, See also 買い場} | Other forms: 売場 【うりば】
うん	うん	JLPT N4	1. yes; yeah; uh huh 2. hum; hmmm; well; erm 3. moan; groan; grunt (of pain) {Only applies to うん} | Other forms: うむ、ううむ
運転手	うんてんしゅ	JLPT N4	[Noun] 1. driver; chauffeur
エスカレーター	エスカレーター	JLPT N4	[Noun] 1. escalator | Other forms: エスカレータ [Notes] エスカレーター: gai1, ichi1.
枝	えだ	JLPT N4	[Noun] 1. branch; bow; bough; twig; limb
選ぶ	えらぶ	JLPT N4	[Godan verb with bu ending, Transitive verb] 1. to choose; to select | Other forms: 撰ぶ 【えらぶ】、択ぶ 【えらぶ】 [Notes] 撰ぶ: Out-dated kanji. 択ぶ: Out-dated kanji.
遠慮	えんりょ	JLPT N4	[Noun, Suru verb] 1. reserve; constraint; restraint; modesty; diffidence; hesitation; holding back; discretion; tact; thoughtfulness 2. declining; refraining 3. forethought; foresight {orig. meaning}
オートバイ	オートバイ	JLPT N4	[Noun] 1. motorcycle {Wasei, word made in Japan, From English “auto-bike”. Wasei (word made in Japan)} [Notes] オートバイ: gai1, ichi1.
お出でになる	おいでになる	JLPT N4	[Expression, Godan verb with ru ending] 1. to be {Usually written using kana alone, Honorific or respectful (sonkeigo), See also お出で} 2. to come 3. to go | Other forms: 御出でになる 【おいでになる】
お祝い	おいわい	JLPT N4	[Noun, Suru verb] 1. congratulation; congratulations; celebration; festival; congratulatory gift {Honorific or respectful (sonkeigo), See also 祝い} | Other forms: 御祝い 【おいわい】、お祝 【おいわい】、御祝 【おいわい】
お蔭	おかげ	JLPT N4	[Noun] 1. grace (of God); benevolence (of Buddha); blessing {Usually written using kana alone} 2. assistance; help; aid {Usually written using kana alone} 3. effects; influence {Usually written using kana alone, See also お蔭で} | Other forms: 御蔭 【おかげ】、お陰 【おかげ】、御陰 【おかげ】
可笑しい	おかしい	JLPT N4	[I-adjective] 1. funny; amusing; comical; laughable; ridiculous {Usually written using kana alone} 2. strange; odd; funny; peculiar; weird; unusual; eccentric {Usually written using kana alone} 3. improper; unsuitable; unbecoming {Usually written using kana alone} 4. suspicious {Usually written using kana alone} | Other forms: 奇怪しい 【おかしい】 [Notes] 奇怪しい: Irregular kanji usage.
億	おく	JLPT N4	[Numeric] 1. 10^8; 100,000,000; hundred million
屋上	おくじょう	JLPT N4	[Noun] 1. rooftop {See also 屋上庭園 おくじょうていえん}
送る	おくる	JLPT N4	[Godan verb with ru ending, Transitive verb] 1. to send (a thing); to dispatch; to despatch; to transmit 2. to take or escort (a person somewhere); to see off (a person) 3. to bid farewell (to the departed); to bury 4. to spend (time); to live one's life 5. to pass (down the line) 6. to affix okurigana {See also 送り仮名}
遅れる	おくれる	JLPT N4	[Ichidan verb, intransitive verb] 1. to be late; to be delayed; to fall behind schedule; to be overdue {See also 遅刻} | Other forms: 後れる 【おくれる】
起こす	おこす	JLPT N4	[Godan verb with su ending, Transitive verb] 1. to raise; to raise up; to set up; to pick up 2. to wake; to wake up; to waken; to awaken 3. to cause; to bring about; to lead to; to trigger; to give rise to; to create; to generate (e.g. heat, electricity); to produce {See also 熾す おこす} 4. to start; to begin; to launch; to establish; to found; to set up; to open {See also 興す おこす} 5. to plough; to plow; to till 6. to fall ill with 7. to transcribe; to write down (what is spoken) 8. to turn over (a card) | Other forms: 起す 【おこす】
行う	おこなう	JLPT N4	[Godan verb with u ending, Transitive verb] 1. to perform; to do; to conduct oneself; to carry out | Other forms: 行なう 【おこなう】
怒る	おこる	JLPT N4	[Godan verb with ru ending, intransitive verb] 1. to get angry; to get mad [Godan verb with ru ending, Transitive verb] 2. to tell someone off; to scold {Only applies to おこる} [Godan verb with ru ending, intransitive verb] 3. to be angular; to be square {Only applies to いかる} | Other forms: 怒る 【いかる】、瞋る 【いかる】 [Notes] 瞋る: Out-dated kanji.
押し入れ	おしいれ	JLPT N4	[Noun] 1. closet | Other forms: 押入 【おしいれ】、押入れ 【おしいれ】
お嬢さん	おじょうさん	JLPT N4	[Noun] 1. daughter {Honorific or respectful (sonkeigo), See also 嬢さん じょうさん} 2. young lady {See also 嬢さん じょうさん} | Other forms: 御嬢さん 【おじょうさん】
お宅	おたく	JLPT N4	[Noun] 1. your house; your home; your family {Honorific or respectful (sonkeigo)} 2. your husband {Honorific or respectful (sonkeigo)} 3. your organization {Honorific or respectful (sonkeigo)} [Pronoun, No-adjective] 4. you (referring to someone of equal status with whom one is not especially close) {Honorific or respectful (sonkeigo)} | Other forms: 御宅 【おたく】
落ちる	おちる	JLPT N4	[Ichidan verb, intransitive verb] 1. to fall down; to drop; to fall (e.g. rain); to sink (e.g. sun or moon); to fall onto (e.g. light or one's gaze); to be used in a certain place (e.g. money) 2. to be omitted; to be missing 3. to decrease; to sink 4. to fail (e.g. exam or class); to lose (contest, election, etc.) 5. to crash; to degenerate; to degrade; to fall behind 6. to become indecent (of a conversation) 7. to be ruined; to go under 8. to fade; to come out (e.g. a stain); to come off (e.g. makeup); to be removed (e.g. illness, possessing spirit, name on a list) {See also 狐が落ちる きつねがおちる} 9. to fall (into someone's hands); to become someone's possession 10. to fall (into a trap); to fall (for a trick) 11. to give in; to give up; to confess; to flee 12. to fall; to be defeated; to surrender 13. to come to (in the end); to end in 14. to fall (in love, asleep, etc.) {See also 恋に落ちる こいにおちる, See also 眠りに落ちる ねむりにおちる} 15. to swoon (judo) 16. to consent; to understand {See also 腑に落ちない ふにおちない} 17. to crash; to freeze {Computer terminology} 18. to die {of animals} 19. to move to the depths {of fish when it gets cold} | Other forms: 堕ちる 【おちる】、墜ちる 【おちる】、落る 【おちる】 [Notes] 落る: Irregular okurigana usage.
仰る	おっしゃる	JLPT N4	[Godan verb - aru special class, Transitive verb] 1. to say; to speak; to tell; to talk {Usually written using kana alone, Honorific or respectful (sonkeigo)} | Other forms: 仰有る 【おっしゃる】、仰しゃる 【おっしゃる】、仰っしゃる 【おっしゃる】
夫	おっと	JLPT N4	[Noun] 1. husband {See also 良人 りょうじん} | Other forms: 良人 【おっと】
お釣り	おつり	JLPT N4	[Noun] 1. change (i.e. money); balance {Polite (teineigo), See also 釣り} | Other forms: 御釣り 【おつり】、御釣 【おつり】
音	おと	JLPT N4	[Noun, Noun - used as a suffix] 1. sound; noise; report 2. note {Music term} 3. fame {Only applies to おと} 4. Chinese-derived character reading {Only applies to おん, See also 訓 くん} | Other forms: 音 【ね】、音 【おん】
落とす	おとす	JLPT N4	[Godan verb with su ending, Transitive verb] 1. to drop; to lose; to let fall; to shed (light); to cast (one's gaze); to pour in (liquid); to leave behind 2. to clean off (dirt, makeup, paint, etc.); to remove (e.g. stains or facial hair); to lose; to spend money at a certain place; to omit; to leave out; to secretly let escape 3. to lose (a match); to reject (an applicant); to fail (a course); to defeat (in an election) 4. to lower (e.g. shoulders or voice); to lessen (e.g. production or body weight); to worsen (quality); to reduce (e.g. rank or popularity); to speak badly of; to make light of; to fall into straitened circumstances 5. to fall into (e.g. a dilemma or sin); to make one's own; to have one's bid accepted; to force surrender; to take (e.g. an enemy camp or castle); to forcefully convince; to press for a confession; to deal with 6. to download; to copy from a computer to another medium {Computer terminology} 7. to make someone swoon (judo) {Martial arts term} 8. to finish a story (e.g. with the punch line) 9. to finish (a period, e.g. of fasting) | Other forms: 落す 【おとす】
踊り	おどり	JLPT N4	[Noun] 1. dance
踊る	おどる	JLPT N4	[Godan verb with ru ending, intransitive verb] 1. to dance (orig. a hopping dance) {See also 舞う, See also 躍る}
驚く	おどろく	JLPT N4	[Godan verb with ku ending, intransitive verb] 1. to be surprised; to be astonished | Other forms: 愕く 【おどろく】、駭く 【おどろく】
お祭り	おまつり	JLPT N4	[Noun] 1. festival; feast; carnival {Polite (teineigo), See also 祭り} | Other forms: お祭 【おまつり】、御祭り 【おまつり】、御祭 【おまつり】
お見舞い	おみまい	JLPT N4	[Noun] 1. calling on someone who is ill; enquiry; inquiry {See also 見舞い} | Other forms: お見舞 【おみまい】、御見舞い 【おみまい】、御見舞 【おみまい】
お土産	おみやげ	JLPT N4	[Noun] 1. present; souvenir {Polite (teineigo), See also 土産 みやげ} | Other forms: お土産 【おみあげ】、御土産 【おみやげ】、御土産 【おみあげ】 [Notes] おみあげ: Irregular kana usage. おみあげ: Irregular kana usage.
思い出す	おもいだす	JLPT N4	[Godan verb with su ending, Transitive verb] 1. to recall; to remember; to recollect | Other forms: 思いだす 【おもいだす】、おもい出す 【おもいだす】、思出す 【おもいだす】 [Notes] 思出す: Irregular okurigana usage.
思う	おもう	JLPT N4	[Godan verb with u ending, Transitive verb] 1. to think; to consider; to believe {想う has connotations of heart-felt} 2. to think (of doing); to plan (to do) 3. to judge; to assess; to regard 4. to imagine; to suppose; to dream 5. to expect; to look forward to 6. to feel; to desire; to want 7. to recall; to remember | Other forms: 想う 【おもう】、念う 【おもう】、憶う 【おもう】、懐う 【おもう】、惟う 【おもう】
玩具	おもちゃ	JLPT N4	[Noun] 1. toy; plaything {Usually written using kana alone} | Other forms: 玩具 【がんぐ】、翫具 【がんぐ】、オモチャ
表	おもて	JLPT N4	[Noun] 1. surface {Antonym: 裏} 2. face (i.e. the visible side of an object) 3. front (of a building, etc.); obverse side (i.e. "head") of a coin 4. outside; exterior 5. appearance 6. public 7. first half (of an inning); top (of an inning) {Baseball term, Antonym: 裏 うら} 8. cover (for tatami mats, etc.) 9. foreground {Computer terminology}
親	おや	JLPT N4	[Noun] 1. parent; parents 2. dealer (in cards, mahjong, etc.) {See also 子 こ} 3. founder 4. (pet) owner | Other forms: 祖 【おや】 [Notes] 祖: Irregular kanji usage.
泳ぎ方	およぎかた	JLPT N4	[Noun] 1. way of swimming
降りる	おりる	JLPT N5	[Ichidan verb, intransitive verb] 1. to descend (e.g. a mountain); to go down; to come down {esp. 下りる} 2. to alight (e.g. from bus); to get off; to disembark; to dismount {esp. 降りる} 3. to step down; to retire; to give up; to quit 4. to be granted; to be issued; to be given {esp. 下りる} 5. to form (of frost, dew, mist, etc.) {esp. 降りる} 6. to be passed (from the body; e.g. of a roundworm) {See also 下り物, esp. 下りる} | Other forms: 下りる 【おりる】
折る	おる	JLPT N4	[Godan verb with ru ending, Transitive verb] 1. to break; to fracture; to break off; to snap off; to pick (e.g. flowers) 2. to fold; to bend 3. to make (origami) 4. to interrupt; to end {See also 筆を折る}
お礼	おれい	JLPT N4	[Noun] 1. thanks; gratitude {Polite (teineigo)} 2. manners; etiquette {Polite (teineigo)} 3. bow {Polite (teineigo)} 4. reward; gift {Polite (teineigo)} 5. ceremony; ritual {Polite (teineigo)} | Other forms: 御礼 【おれい】、御礼 【おんれい】
折れる	おれる	JLPT N4	[Ichidan verb, intransitive verb] 1. to break; to be broken; to snap; to fracture 2. to be folded 3. to give in; to back down; to yield; to submit 4. to turn (a corner) {See also 曲がる}
終わり	おわり	JLPT N4	[Noun] 1. the end | Other forms: 終り 【おわり】、終 【おわり】 [Notes] 終: Irregular okurigana usage.
カーテン	カーテン	JLPT N4	[Noun] 1. curtain; curtains
海岸	かいがん	JLPT N4	[Noun, No-adjective] 1. coast; beach [Place] 2. Kaigan
会議	かいぎ	JLPT N4	[Noun, Suru verb, No-adjective] 1. meeting; conference; session; assembly; council; convention; congress
会議室	かいぎしつ	JLPT N4	[Noun] 1. conference room; council room
会場	かいじょう	JLPT N4	[Noun] 1. assembly hall; meeting place; venue; grounds
会話	かいわ	JLPT N4	[Noun, Suru verb] 1. conversation
帰り	かえり	JLPT N4	[Noun] 1. return; coming back | Other forms: 還り 【かえり】
変える	かえる	JLPT N4	[Ichidan verb, Transitive verb] 1. to change; to alter; to transform; to convert; to turn; to vary 2. to reform; to revise; to amend
科学	かがく	JLPT N4	[Noun] 1. science
鏡	かがみ	JLPT N4	[Noun] 1. mirror; looking-glass 2. barrel head
掛ける	かける	JLPT N5	[Ichidan verb, Transitive verb] 1. to hang (e.g. picture); to hoist (e.g. sail); to raise (e.g. flag) {Usually written using kana alone, See also 壁にかける} 2. to sit {Usually written using kana alone, See also 腰を掛ける} 3. to take (time, money); to expend (money, time, etc.) {Usually written using kana alone, See also 時間を掛ける} 4. to make (a call) {Usually written using kana alone, See also 電話を掛ける} 5. to multiply {Usually written using kana alone} 6. to secure (e.g. lock) {Usually written using kana alone, See also 鍵を掛ける} 7. to put on (glasses, etc.) {Usually written using kana alone, See also 眼鏡を掛ける} 8. to cover {Usually written using kana alone} 9. to burden someone {Usually written using kana alone, See also 迷惑を掛ける} 10. to apply (insurance) {Usually written using kana alone, See also 保険を掛ける} 11. to turn on (an engine, etc.); to set (a dial, an alarm clock, etc.) {Usually written using kana alone} 12. to put an effect (spell, anaesthetic, etc.) on {Usually written using kana alone} 13. to hold an emotion for (pity, hope, etc.) {Usually written using kana alone} 14. to bind {Usually written using kana alone, also 繋ける} 15. to pour (or sprinkle, spray, etc.) onto {Usually written using kana alone, See also 塩をかける} 16. to argue (in court); to deliberate (in a meeting); to present (e.g. idea to a conference, etc.) {Usually written using kana alone, See also 裁判に掛ける} 17. to increase further {Usually written using kana alone} 18. to catch (in a trap, etc.) {Usually written using kana alone} 19. to set atop {Usually written using kana alone} 20. to erect (a makeshift building) {Usually written using kana alone} 21. to hold (a play, festival, etc.) {Usually written using kana alone} 22. to wager; to bet; to risk; to stake; to gamble {Usually written using kana alone, See also 賭ける かける} [Suffix, Ichidan verb] 23. to be partway doing ...; to begin (but not complete) ...; to be about to ... {Usually written using kana alone, See also 話し掛ける, after -masu stem of verb} 24. indicates (verb) is being directed to (someone) {Usually written using kana alone, See also 話し掛ける, after -masu stem of verb} | Other forms: 懸ける 【かける】
飾る	かざる	JLPT N4	[Godan verb with ru ending, Transitive verb] 1. to decorate; to ornament; to adorn | Other forms: 餝る 【かざる】、錺る 【かざる】、荘る 【かざる】 [Notes] 餝る: Out-dated kanji. 錺る: Out-dated kanji. 荘る: Out-dated kanji.
火事	かじ	JLPT N4	[Noun] 1. fire; conflagration
瓦斯	ガス	JLPT N4	[Noun] 1. gas (state of matter, e.g. poison gas, natural gas) {Usually written using kana alone, From Dutch; Flemish , From English } 2. gasoline; gas; petrol {Usually written using kana alone} 3. dense fog; thick fog {Usually written using kana alone} 4. gas stove; gas cooker; gas range {Usually written using kana alone, Abbreviation, See also ガス焜炉} 5. flatulence; gas; wind; fart {Usually written using kana alone, Colloquialism} [Notes] 瓦斯: Ateji (phonetic) reading.
ガソリン	ガソリン	JLPT N4	[Noun] 1. gasoline; petrol [Notes] ガソリン: gai1, ichi1.
ガソリンスタンド	ガソリンスタンド	JLPT N4	[Noun] 1. gas station; petrol station {Wasei, word made in Japan, From English “gasoline stand”. Wasei (word made in Japan)} | Other forms: ガソリン・スタンド
硬い	かたい	JLPT N4	[I-adjective] 1. hard; solid; tough {esp. 固い and 堅い for wood, 硬い for metal and stone} 2. stiff; tight; wooden; unpolished (e.g. writing) 3. strong; firm (not viscous or easily moved) 4. safe; steady; honest; steadfast 5. obstinate; stubborn 6. bookish; formal; stuffy {Antonym: 砕けた} | Other forms: 固い 【かたい】、堅い 【かたい】、緊い 【かたい】 [Notes] 緊い: Irregular kanji usage.
形	かたち	JLPT N4	[Noun] 1. form; shape; figure {Only applies to 形, Only applies to 容} 2. visage | Other forms: 容 【かたち】、貌 【かたち】、容 【よう】
片付ける	かたづける	JLPT N4	[Ichidan verb, Transitive verb] 1. to tidy up; to put in order; to straighten up; to put away 2. to settle (problem); to clear (dispute) 3. to finish; to bring something to an end 4. to marry off (e.g. a daughter) {sometimes 嫁ける} 5. to do away with someone; to bump someone off | Other forms: 片づける 【かたづける】
課長	かちょう	JLPT N4	[Noun] 1. section manager; section chief
勝つ	かつ	JLPT N4	[Godan verb with tsu ending, intransitive verb] 1. to win; to gain victory | Other forms: 克つ 【かつ】、贏つ 【かつ】
家内	かない	JLPT N4	[Noun] 1. (my) wife {Humble (kenjougo), Only applies to かない} 2. inside the home; one's family | Other forms: 家内 【やうち】 [Notes] やうち: Out-dated or obsolete kana usage.
悲しい	かなしい	JLPT N4	[I-adjective] 1. sad; sorrowful | Other forms: 哀しい 【かなしい】 [Notes] 哀しい: Out-dated kanji.
必ず	かならず	JLPT N4	[Adverb] 1. always; without exception; necessarily; certainly; without fail; positively; invariably
彼女	かのじょ	JLPT N4	[Pronoun] 1. she; her [No-adjective] 2. her [Noun] 3. girlfriend; sweetheart
壁	かべ	JLPT N4	[Noun] 1. wall; partition 2. barrier; obstacle 3. Chinese "Wall" constellation (one of the 28 mansions) {Astronomy, etc. term, Only applies to へき, See also 二十八宿, See also 玄武 げんぶ} | Other forms: 壁 【へき】 [Notes] かべ: ichi1, news1, nf02. 壁: ichi1, news1, nf02. 壁: ichi1, news1, nf02.
髪	かみ	JLPT N4	[Noun] 1. hair (on the head) | Other forms: 髮 【かみ】 [Notes] 髮: Out-dated kanji.
噛む	かむ	JLPT N4	[Godan verb with mu ending, Transitive verb] 1. to bite; to chew; to gnaw 2. to crash against (e.g. of waves); to break onto (shore) 3. to engage (of cogs, zippers, etc.); to mesh; to fit together 4. to be involved in {See also 一枚噛む} 5. to fumble one's words (during a play, broadcast, etc.); to falter with one's words 6. to strongly confute; to argue down; to rebuke; to scold harshly {Archaism} | Other forms: 咬む 【かむ】、嚙む 【かむ】、嚼む 【かむ】
通う	かよう	JLPT N4	[Godan verb with u ending, intransitive verb] 1. to go to and from (a place); to go back and forth between; to run between (e.g. bus, train, etc.); to ply between 2. to go to (school, work, etc.); to attend; to commute; to frequent 3. to circulate (e.g. blood, electricity); to be communicated (e.g. thought) {See also 血が通う, See also 心が通う} 4. to resemble
硝子	ガラス	JLPT N4	[Noun] 1. glass; pane {Usually written using kana alone, From Dutch; Flemish “glas”} [Noun or verb acting prenominally] 2. vitreous {See also 硝子体 しょうしたい} | Other forms: 硝子 【しょうし】
彼	かれ	JLPT N4	[Pronoun] 1. he; him [No-adjective] 2. his [Noun] 3. boyfriend
乾く	かわく	JLPT N4	[Godan verb with ku ending, intransitive verb] 1. to get dry
代わり	かわり	JLPT N4	[Noun, No-adjective] 1. substitute; replacement; substituting; replacing 2. stand-in; proxy; alternate; deputy; relief; successor 3. compensation; exchange; return {See also 代わりに, usu. as 〜代わりに, etc.} 4. second helping; another cup; seconds {See also お代わり おかわり, usu. as お代わり} 5. upcoming program; upcoming programme {Abbreviation, See also 替わり狂言, esp. 替わり, 替り} | Other forms: 替わり 【かわり】、代り 【かわり】、替り 【かわり】
変わる	かわる	JLPT N4	[Godan verb with ru ending, intransitive verb] 1. to change; to be transformed; to be altered; to vary 2. to move to 3. to be different; to be uncommon; to be unusual {See also 変わった, See also 変わっている, usu. as 変わった, 変わっている} | Other forms: 変る 【かわる】
考える	かんがえる	JLPT N4	[Ichidan verb, Transitive verb] 1. to think about; to take into consideration 2. to ponder; to reflect; to try to come at a conclusion; to think over (something) 3. to intend; to decide (to do); to plan 4. to come up with; to devise; to scheme 5. to predict; to anticipate; to expect 6. to suspect; to doubt 7. to consider (somebody to be something); to look on | Other forms: 勘える 【かんがえる】、稽える 【かんがえる】
関係	かんけい	JLPT N4	[Noun, Suru verb, No-adjective] 1. relation; relationship; connection 2. participation; involvement; concern 3. influence; effect [Noun, Suru verb] 4. sexual relations; sexual relationship [Noun - used as a suffix] 5. related to ...; connected to ... [Wikipedia definition] 6. Relation
看護師	かんごし	JLPT N4	[Noun] 1. (hospital) nurse; registered nurse; RN
簡単	かんたん	JLPT N4	[Na-adjective, Noun] 1. simple; easy; uncomplicated 2. brief; quick; light | Other forms: 簡短 【かんたん】、簡端 【かんたん】 [Notes] 簡短: Out-dated kanji. 簡端: Out-dated kanji.
気	き	JLPT N4	[Noun] 1. spirit; mind; heart {See also 気を逸らす} 2. nature; disposition {See also 気が小さい} 3. motivation; intention {See also やる気, See also 気がない, usu. after a verb} 4. mood; feelings {See also 気が重い} 5. ambience; atmosphere; mood | Other forms: 氣 【き】 [Notes] 氣: Out-dated kanji.
機会	きかい	JLPT N4	[Noun] 1. chance; opportunity
危険	きけん	JLPT N4	[Noun, Na-adjective] 1. danger; peril; hazard {Antonym: 安全} 2. risk [Wikipedia definition] 3. Danger
聞こえる	きこえる	JLPT N4	[Ichidan verb, intransitive verb] 1. to be heard; to be audible 2. to be said to be; to be reputed | Other forms: 聞える 【きこえる】、聴こえる 【きこえる】、聴える 【きこえる】 [Notes] 聴こえる: Irregular kanji usage. 聴える: Irregular kanji usage.
汽車	きしゃ	JLPT N4	[Noun] 1. train (sometimes specifically a steam train)
技術	ぎじゅつ	JLPT N4	[Noun] 1. technology; engineering 2. technique; skill 3. art; craft
季節	きせつ	JLPT N4	[Noun, No-adjective] 1. season
規則	きそく	JLPT N4	[Noun] 1. rules; regulations; conventions
屹度	きっと	JLPT N4	[Adverb] 1. surely; undoubtedly; almost certainly; most likely (e.g. 90 percent) {Usually written using kana alone, Onomatopoeic or mimetic word} 2. sternly; severely {Usually written using kana alone, Onomatopoeic or mimetic word, esp. キッと} 3. having no slack; rigid; stiff; tight {Usually written using kana alone, Onomatopoeic or mimetic word} 4. suddenly; abruptly; instantly {Usually written using kana alone, Onomatopoeic or mimetic word, Archaism} | Other forms: 急度 【きっと】、キッと [Notes] 屹度: Ateji (phonetic) reading. 急度: Ateji (phonetic) reading.
絹	きぬ	JLPT N4	[Noun] 1. silk [Notes] きぬ: ichi1, news1, nf12. 絹: ichi1, news1, nf12.
厳しい	きびしい	JLPT N4	[I-adjective] 1. severe; strict; rigid; unsparing; relentless 2. intense (e.g. cold); harsh; tough | Other forms: 酷しい 【きびしい】
気分	きぶん	JLPT N4	[Noun] 1. feeling; mood
決まる	きまる	JLPT N4	[Godan verb with ru ending, intransitive verb] 1. to be decided; to be settled 2. to look good in (clothes) | Other forms: 決る 【きまる】、極る 【きまる】 [Notes] 決る: Irregular okurigana usage.
君	きみ	JLPT N4	[Pronoun, No-adjective] 1. you; buddy; pal {Male term or language, Familiar language, also used colloquially by young females} [Noun] 2. monarch; ruler; sovereign; (one's) master {orig. meaning} | Other forms: 公 【きみ】
決める	きめる	JLPT N4	[Ichidan verb, Transitive verb] 1. to decide; to choose; to determine; to make up one's mind; to resolve; to set one's heart on; to settle; to arrange; to set; to appoint; to fix 2. to clinch (a victory); to decide (the outcome of a match) 3. to persist in doing; to go through with 4. to always do; to have made a habit of {as 決めている} 5. to take for granted; to assume 6. to dress up; to dress to kill; to dress to the nines 7. to carry out successfully (a move in sports, a pose in dance, etc.); to succeed in doing 8. to immobilize with a double-arm lock (in sumo, judo, etc.) {Martial arts term, Sumo term} 9. to eat or drink something; to take illegal drugs | Other forms: 極める 【きめる】
気持ち	きもち	JLPT N4	[Noun] 1. feeling; sensation; mood 2. preparedness; readiness; attitude 3. thanks; solicitude; sympathy {Humble (kenjougo)} [Adverb] 4. just a little; somewhat; slightly | Other forms: 気持 【きもち】
着物	きもの	JLPT N4	[Noun] 1. clothing; clothes 2. kimono (or other trad. Japanese clothing)
客	きゃく	JLPT N4	[Noun] 1. guest; visitor 2. customer; client; shopper; spectator; audience; tourist; sightseer; passenger [Place] 3. Kyaku | Other forms: 客 【かく】
急	きゅう	JLPT N4	[Na-adjective] 1. urgent; sudden; abrupt 2. sharp; steep; precipitous 3. rapid; swift; fast [Noun] 4. emergency; crisis 5. hurrying; haste 6. (in gagaku or noh) end of a song {See also 序破急}
急行	きゅうこう	JLPT N4	[Noun, Suru verb, No-adjective] 1. moving at high speed {Antonym: 緩行} 2. express (e.g. train that bypasses many stations) {Abbreviation, See also 急行列車}
教育	きょういく	JLPT N4	[Noun, No-adjective, Suru verb] 1. training; education
教会	きょうかい	JLPT N4	[Noun] 1. church
競争	きょうそう	JLPT N4	[Noun, No-adjective] 1. competition; contest [Suru verb] 2. to compete
興味	きょうみ	JLPT N4	[Noun] 1. interest (in something); curiosity (about something); zest (for)
近所	きんじょ	JLPT N4	[Noun, No-adjective] 1. neighbourhood; neighborhood [Place] 2. Kinjo
具合	ぐあい	JLPT N4	[Noun] 1. condition; state; manner; health | Other forms: 具合い 【ぐあい】、工合 【ぐあい】
空気	くうき	JLPT N4	[Noun] 1. air; atmosphere 2. mood; situation {See also 空気を読む くうきをよむ} 3. someone with no presence; someone who doesn't stand out at all {Colloquialism}
空港	くうこう	JLPT N4	[Noun] 1. airport
草	くさ	JLPT N4	[Noun] 1. grass; weed; herb; thatch 2. ninja {Archaism} [Prefix] 3. not genuine; substandard [Expression] 4. laughter; LOL {Slang} | Other forms: 艸 【くさ】 [Notes] 艸: Out-dated kanji.
首	くび	JLPT N4	[Noun] 1. neck 2. head 3. dismissal; discharge; firing (from a job) {Usually written using kana alone, also written as 馘} | Other forms: 頸 【くび】、頚 【くび】、クビ
雲	くも	JLPT N4	[Noun] 1. cloud
比べる	くらべる	JLPT N4	[Ichidan verb, Transitive verb] 1. to compare; to make a comparison {See also 見比べる} 2. to compete; to vie {See also 力比べ} | Other forms: 較べる 【くらべる】、競べる 【くらべる】
呉れる	くれる	JLPT N4	[Ichidan verb (kureru special class), Transitive verb, Auxiliary verb] 1. to give; to let one have; to do for one; to be given {Usually written using kana alone, くれ is an irregular alternative imperative form}
暮れる	くれる	JLPT N4	[Ichidan verb, intransitive verb] 1. to get dark 2. to end; to come to an end; to close; to run out 3. to be sunk (e.g. in despair); to be lost | Other forms: 眩れる 【くれる】、暗れる 【くれる】
君	くん	JLPT N4	[Noun, Suffix] 1. Mr (junior); master; boy
毛	け	JLPT N4	[Noun] 1. hair 2. fur; wool 3. down; plumage; feathers
ケーキ	ケーキ	JLPT N4	[Noun] 1. cake
経済	けいざい	JLPT N4	[Noun, Suru verb] 1. economics; business; finance; economy
警察	けいさつ	JLPT N4	[Noun, No-adjective] 1. police 2. police officer {Abbreviation, See also 警察官} 3. police station {Abbreviation, See also 警察署}
景色	けしき	JLPT N4	[Noun, No-adjective] 1. scenery; scene; landscape | Other forms: 景色 【けいしょく】
消しゴム	けしゴム	JLPT N4	[Noun] 1. eraser; India rubber
下宿	げしゅく	JLPT N4	[Noun, Suru verb] 1. boarding; lodging; boarding house
決して	けっして	JLPT N4	[Adverb] 1. never; by no means; not in the least; in no way {with neg. verb} | Other forms: 決して 【けして】 [Notes] けして: Irregular kana usage.
けど	けど	JLPT N4	[Conjunction, Particle] 1. but; however; although | Other forms: けれど、けれども、けども、けんど
原因	げんいん	JLPT N4	[Noun] 1. cause; origin; source
喧嘩	けんか	JLPT N4	[Noun, Suru verb] 1. quarrel; brawl; fight; squabble; scuffle; argument | Other forms: 諠譁 【けんか】、ケンカ
研究	けんきゅう	JLPT N4	[Noun, Suru verb] 1. study; research; investigation
研究室	けんきゅうしつ	JLPT N4	[Noun] 1. laboratory 2. seminar room 3. professor's office
見物	けんぶつ	JLPT N4	[Noun, Suru verb] 1. sightseeing; watching; viewing [Noun] 2. sightseer; watcher; spectator {Abbreviation, See also 見物人 けんぶつにん, See also 見物客 けんぶつきゃく} [Place] 3. Kenbutsu
子	こ	JLPT N4	[Noun, Noun - used as a suffix] 1. child 2. young (animal) {See also 仔 こ} 3. young woman; young geisha {also 娘} 4. offshoot 5. interest {See also 元も子もない} 6. new shares {Abbreviation, See also 子株} [Noun] 7. player who is not a dealer (in cards, mahjong, etc.) {See also 親 おや} [Noun, Noun - used as a suffix] 8. bird egg {Archaism} [Noun - used as a suffix] 9. -er (often of young women) {after a noun or -masu stem} | Other forms: 児 【こ】
斯う	こう	JLPT N4	[Adverb] 1. in this way (used for something or someone close to the speaker, including the speaker himself, or for the opinions of the speaker); thus; such {Usually written using kana alone, See also 然う, See also ああ, See also 如何 どう} 2. uh... (interjection used as a verbal pause) {Usually written using kana alone}
郊外	こうがい	JLPT N4	[Noun, No-adjective] 1. suburb; outskirts
講義	こうぎ	JLPT N4	[Noun, Suru verb] 1. lecture
工業	こうぎょう	JLPT N4	[Noun] 1. (manufacturing) industry
高校	こうこう	JLPT N4	[Noun] 1. senior high school; high school {Abbreviation, See also 高等学校} [Place] 2. Koukou
高校生	こうこうせい	JLPT N4	[Noun] 1. senior high school student
工場	こうじょう	JLPT N4	[Noun] 1. factory; plant; mill; workshop | Other forms: 工場 【こうば】
校長	こうちょう	JLPT N4	[Noun] 1. principal; headmaster
交通	こうつう	JLPT N4	[Noun, Suru verb] 1. traffic; transportation; communication; exchange (of ideas, etc.); intercourse
講堂	こうどう	JLPT N4	[Noun] 1. auditorium; lecture hall [Notes] こうどう: ichi1, news1, nf10. 講堂: ichi1, news1, nf10.
高等学校	こうとうがっこう	JLPT N4	[Noun] 1. senior high school; high school
公務員	こうむいん	JLPT N4	[Noun] 1. government worker; public servant; civil servant
国際	こくさい	JLPT N4	[Noun, No-adjective] 1. international
心	こころ	JLPT N4	[Noun] 1. mind; heart; spirit 2. the meaning of a phrase (riddle, etc.)
ご主人	ごしゅじん	JLPT N4	[Noun] 1. your husband; her husband {Honorific or respectful (sonkeigo), See also 主人} | Other forms: 御主人 【ごしゅじん】
故障	こしょう	JLPT N4	[Noun, Suru verb] 1. breakdown; failure; fault; accident; out of order 2. damage; hurt 3. objection; protest
ご存じ	ごぞんじ	JLPT N4	[Noun] 1. knowing {Honorific or respectful (sonkeigo), See also 存じ} 2. (an) acquaintance | Other forms: ご存知 【ごぞんじ】、御存じ 【ごぞんじ】、御存知 【ごぞんじ】 [Notes] ご存知: Ateji (phonetic) reading. 御存知: Ateji (phonetic) reading.
答え	こたえ	JLPT N4	[Noun] 1. answer; reply; response; solution | Other forms: 答 【こたえ】、応え 【こたえ】、報え 【こたえ】、答え 【いらえ】、応え 【いらえ】
ご馳走	ごちそう	JLPT N4	[Noun] 1. feast; treating (someone) {Polite (teineigo), See also 馳走} [Suru verb] 2. to treat (someone, e.g. to a meal) | Other forms: 御馳走 【ごちそう】
小鳥	ことり	JLPT N4	[Noun] 1. small bird; songbird 2. birdie; dickeybird; dickybird {Children's language}
この間	このあいだ	JLPT N4	[Temporal noun, Adverbial noun] 1. the other day; lately; recently; during this period 2. meanwhile; in the meantime {Only applies to このかん} | Other forms: この間 【このかん】、此の間 【このあいだ】、此の間 【このかん】
この頃	このごろ	JLPT N4	[Adverbial noun, Temporal noun] 1. recently; nowadays; these days; now; at present | Other forms: この頃 【このころ】、此の頃 【このごろ】、此の頃 【このころ】 [Notes] このころ: Out-dated or obsolete kana usage. このころ: Out-dated or obsolete kana usage.
細かい	こまかい	JLPT N4	[I-adjective] 1. small 2. fine; minute 3. minor; trivial {See also 細かいこと} 4. sensitive; attentive {See also 神経が細かい}
込む	こむ	JLPT N4	[Godan verb with mu ending, intransitive verb] 1. to be crowded; to be packed 2. to be complex {See also 手の込んだ} [Auxiliary verb] 3. to go into; to put into; to remain (seated); to be plunged into (silence); to do thoroughly {Only applies to 込む} 4. to do intently {Only applies to 込む} 5. to continue in the same state {Only applies to 込む} | Other forms: 混む 【こむ】、籠む 【こむ】、篭む 【こむ】 [Notes] 籠む: Irregular kanji usage. 篭む: Irregular kanji usage.
米	こめ	JLPT N4	[Noun] 1. (husked grains of) rice 2. 88 years old {Only applies to よね, 米 is composed of 八十八} | Other forms: 米 【よね】、米 【めめ】、コメ [Notes] よね: Out-dated or obsolete kana usage. めめ: Out-dated or obsolete kana usage.
ご覧になる	ごらんになる	JLPT N4	[Expression, Godan verb with ru ending] 1. to see; to look; to watch {Honorific or respectful (sonkeigo), See also 見る} 2. try to {after the -te form of a verb} | Other forms: 御覧になる 【ごらんになる】、ご覧に成る 【ごらんになる】、御覧に成る 【ごらんになる】
此れから	これから	JLPT N4	[Temporal noun] 1. after this {Usually written using kana alone} | Other forms: 此から 【これから】 [Notes] 此から: Irregular okurigana usage.
怖い	こわい	JLPT N4	[I-adjective] 1. scary; frightening; eerie; dreadful 2. (I'm) afraid | Other forms: 恐い 【こわい】
壊す	こわす	JLPT N4	[Godan verb with su ending, Transitive verb] 1. to break; to destroy; to demolish 2. to wreck; to ruin; to spoil; to damage 3. to break (a bill, etc.) | Other forms: 毀す 【こわす】
壊れる	こわれる	JLPT N4	[Ichidan verb, intransitive verb] 1. to be broken; to break 2. to fall through; to come to nothing | Other forms: 毀れる 【こわれる】
コンサート	コンサート	JLPT N4	[Noun] 1. concert
今度	こんど	JLPT N4	[Adverbial noun, Temporal noun] 1. this time; now 2. next time; another time; shortly; soon 3. recently; previous; last
コンピュータ	コンピュータ	JLPT N4	[Noun] 1. computer | Other forms: コンピューター
今夜	こんや	JLPT N4	[Adverbial noun, Temporal noun] 1. this evening; tonight
最近	さいきん	JLPT N4	[No-adjective, Adverbial noun, Temporal noun] 1. most recent; these days; right now; recently; nowadays
最後	さいご	JLPT N4	[Noun, No-adjective] 1. last; end; conclusion; latest; most recent [Expression] 2. no sooner than; right after (often having negative consequences) {after -tara form or -ta form followed by "ga"} 3. one's final moments {Archaism, See also 最期}
最初	さいしょ	JLPT N4	[No-adjective, Adverbial noun, Temporal noun] 1. beginning; outset; first; onset
坂	さか	JLPT N4	[Noun] 1. slope; hill | Other forms: 阪 【さか】
探す	さがす	JLPT N4	[Godan verb with su ending, Transitive verb] 1. to search (for something desired, needed); to look for {esp. 探す} 2. to search (for something lost); to seek (a suspect in a crime) {esp. 捜す} | Other forms: 捜す 【さがす】
下がる	さがる	JLPT N4	[Godan verb with ru ending, intransitive verb] 1. to come down; to go down; to fall; to drop; to sink; to get lower {Antonym: 上がる} 2. to hang; to dangle 3. to move back; to step back; to withdraw; to retire 4. to deteriorate; to fall off; to be downgraded 5. to get closer to the present day 6. to go south {in Kyoto} | Other forms: 下る 【さがる】 [Notes] 下る: Irregular okurigana usage.
盛ん	さかん	JLPT N4	[Na-adjective] 1. popular 2. prosperous 3. enthusiastic 4. energetic; vigorous {also written as 壮}
下げる	さげる	JLPT N4	[Ichidan verb, Transitive verb] 1. to hang; to suspend; to wear (e.g. decoration) 2. to lower; to reduce; to bring down 3. to demote; to move back; to pull back 4. to clear (plates); to remove (food, etc. from table or altar)
差し上げる	さしあげる	JLPT N4	[Auxiliary verb, Ichidan verb, Transitive verb] 1. to give; to offer {Humble (kenjougo)} [Ichidan verb, Transitive verb] 2. to lift up; to hold up; to raise {Humble (kenjougo)} | Other forms: 差上げる 【さしあげる】、さし上げる 【さしあげる】 [Notes] 差上げる: Irregular okurigana usage.
さっき	さっき	JLPT N4	[Adverbial noun, Noun] 1. some time ago; just now {See also 先 さき}
寂しい	さびしい	JLPT N4	[I-adjective] 1. lonely; lonesome; solitary; desolate | Other forms: 寂しい 【さみしい】、淋しい 【さびしい】、淋しい 【さみしい】
再来月	さらいげつ	JLPT N4	[Adverbial noun, Temporal noun] 1. month after next | Other forms: さ来月 【さらいげつ】
再来週	さらいしゅう	JLPT N4	[Adverbial noun, Temporal noun] 1. week after next | Other forms: さ来週 【さらいしゅう】
サラダ	サラダ	JLPT N4	[Noun] 1. salad {From Portuguese }
騒ぐ	さわぐ	JLPT N4	[Godan verb with gu ending, intransitive verb] 1. to make noise; to make racket; to be noisy 2. to rustle; to swoosh 3. to make merry 4. to clamor; to clamour; to make a fuss; to kick up a fuss 5. to lose one's cool; to panic; to act flustered 6. to feel tense; to be uneasy; to be excited | Other forms: 騷ぐ 【さわぐ】 [Notes] 騷ぐ: Out-dated kanji.
触る	さわる	JLPT N4	[Godan verb with ru ending, intransitive verb] 1. to touch; to feel {often now with を}
産業	さんぎょう	JLPT N4	[Noun, No-adjective] 1. industry [Noun] 2. livelihood; occupation {Archaism} [Place] 3. Sangyou
サンダル	サンダル	JLPT N4	[Noun] 1. sandal [Notes] サンダル: gai1.
サンドイッチ	サンドイッチ	JLPT N4	[Noun] 1. sandwich | Other forms: サンドウィッチ [Notes] サンドイッチ: gai1, ichi1.
残念	ざんねん	JLPT N4	[Na-adjective, Noun] 1. deplorable; bad luck; regret; disappointment
市	し	JLPT N4	[Noun, Noun - used as a suffix] 1. city
字	じ	JLPT N4	[Noun] 1. character (i.e. kanji) 2. hand-writing; penmanship 3. the ... word (i.e. "the L word" = "love") {See also ほの字, as 〜の字}
試合	しあい	JLPT N4	[Noun, Suru verb] 1. match; game; bout; contest | Other forms: 仕合 【しあい】 [Notes] 試合: Ateji (phonetic) reading. 仕合: Ateji (phonetic) reading.
仕方	しかた	JLPT N4	[Noun] 1. way; method; means; resource; course | Other forms: 仕形 【しかた】
試験	しけん	JLPT N4	[Noun, Suru verb] 1. examination; test; study; trial; experiment
事故	じこ	JLPT N4	[Noun] 1. accident; incident; trouble 2. circumstances; reasons | Other forms: 事故 【ことゆえ】 [Notes] ことゆえ: Out-dated or obsolete kana usage.
地震	じしん	JLPT N4	[Noun] 1. earthquake | Other forms: 地震 【ない】、地震 【なえ】、地震 【じぶるい】 [Notes] ない: Out-dated or obsolete kana usage. なえ: Out-dated or obsolete kana usage. じぶるい: Out-dated or obsolete kana usage.
時代	じだい	JLPT N4	[Temporal noun, Noun] 1. period; epoch; era; age 2. the times; those days 3. oldness; ancientness; antiquity 4. antique; period piece {Abbreviation, See also 時代物}
下着	したぎ	JLPT N4	[Noun] 1. underwear
確り	しっかり	JLPT N4	[Adverb, Adverb taking the 'to' particle, Suru verb] 1. tightly (holding on); firmly; securely {Usually written using kana alone, Onomatopoeic or mimetic word} 2. strongly (built); solidly; sturdily; steadily {Usually written using kana alone, Onomatopoeic or mimetic word} 3. properly; well; sufficiently; hard (working, etc.); fully; completely {Usually written using kana alone, Onomatopoeic or mimetic word} 4. reliably; dependably; levelheadedly; shrewdly; wisely; cleverly {Usually written using kana alone, Onomatopoeic or mimetic word} | Other forms: 聢り 【しっかり】
失敗	しっぱい	JLPT N4	[Noun, No-adjective, Suru verb] 1. failure; mistake; blunder
辞典	じてん	JLPT N4	[Noun] 1. dictionary | Other forms: 辭典 【じてん】、辞典 【ことばてん】、辭典 【ことばてん】、言葉典 【ことばてん】、ことば典 【ことばてん】 [Notes] 辭典: Out-dated kanji. 辭典: Out-dated kanji.
品物	しなもの	JLPT N4	[Noun] 1. goods; article; thing
暫く	しばらく	JLPT N4	[Adverb, No-adjective] 1. little while; short while; moment; instant {Usually written using kana alone} 2. a while; quite a time {Usually written using kana alone} 3. it's been a long time {Usually written using kana alone} | Other forms: 姑く 【しばらく】、須臾 【しばらく】、暫らく 【しばらく】、須臾 【しゅゆ】、須臾 【すゆ】 [Notes] 暫らく: Irregular okurigana usage.
島	しま	JLPT N4	[Noun] 1. island 2. territory (of a prostitute, organized crime gang, etc.); turf {Usually written using kana alone} | Other forms: 嶋 【しま】
市民	しみん	JLPT N4	[Noun] 1. citizen; citizenry; public 2. city inhabitant; townspeople 3. bourgeoisie; middle class
事務所	じむしょ	JLPT N4	[Noun] 1. office
社会	しゃかい	JLPT N4	[Noun] 1. society; public; community; the world 2. social studies {Abbreviation, See also 社会科 しゃかいか}
社長	しゃちょう	JLPT N4	[Noun] 1. company president; manager; director
ジャム	ジャム	JLPT N4	[Noun] 1. jam
自由	じゆう	JLPT N4	[Expression, Na-adjective, Noun] 1. freedom; liberty; as it pleases you
習慣	しゅうかん	JLPT N4	[Noun, No-adjective] 1. habit 2. custom; cultural practice
住所	じゅうしょ	JLPT N4	[Noun] 1. address (e.g. of house); residence; domicile | Other forms: 住処 【じゅうしょ】
柔道	じゅうどう	JLPT N4	[Noun] 1. judo
十分	じゅうぶん	JLPT N4	[Na-adjective] 1. plenty; enough; sufficient; satisfactory; adequate [Noun, Suru verb] 2. division into ten {Only applies to 十分} [Adverb] 3. perfectly; thoroughly; fully; in full | Other forms: 充分 【じゅうぶん】
趣味	しゅみ	JLPT N4	[Noun] 1. hobby; pastime 2. tastes; preference; liking
紹介	しょうかい	JLPT N4	[Noun, Suru verb, No-adjective] 1. introduction; presentation; referral; listing
小学校	しょうがっこう	JLPT N4	[Noun] 1. primary school; elementary school; grade school
小説	しょうせつ	JLPT N4	[Noun, No-adjective] 1. novel; (short) story
将来	しょうらい	JLPT N4	[Adverbial noun, Temporal noun] 1. future (usually near); prospects
食料品	しょくりょうひん	JLPT N4	[Noun] 1. foodstuff; groceries
女性	じょせい	JLPT N4	[Noun, No-adjective] 1. woman; female 2. feminine gender {linguistics terminology, Only applies to じょせい} | Other forms: 女性 【にょしょう】
知らせる	しらせる	JLPT N4	[Ichidan verb, Transitive verb] 1. to notify; to advise; to inform | Other forms: 報せる 【しらせる】
調べる	しらべる	JLPT N4	[Ichidan verb, Transitive verb] 1. to examine; to investigate; to check up; to sense; to study; to inquire; to search
人口	じんこう	JLPT N4	[Noun] 1. population 2. common talk
神社	じんじゃ	JLPT N4	[Noun] 1. Shinto shrine
親切	しんせつ	JLPT N4	[Na-adjective, Noun] 1. kindness; gentleness | Other forms: 深切 【しんせつ】 [Notes] 深切: Out-dated kanji.
新聞社	しんぶんしゃ	JLPT N4	[Noun] 1. newspaper company
スーツ	スーツ	JLPT N4	[Noun] 1. suit [Notes] スーツ: gai1, ichi1.
スーツケース	スーツケース	JLPT N4	[Noun] 1. suitcase
水泳	すいえい	JLPT N4	[Noun, Suru verb, No-adjective] 1. swimming
水道	すいどう	JLPT N4	[Noun] 1. water service; water supply [Place] 2. Suidou
数学	すうがく	JLPT N4	[Noun] 1. mathematics; arithmetic
過ぎる	すぎる	JLPT N4	[Ichidan verb, intransitive verb] 1. to pass through; to pass by; to go beyond 2. to pass (i.e. of time); to elapse 3. to have expired; to have ended; to be over 4. to exceed; to surpass; to be above 5. to be no more than ... {as 〜に過ぎない, etc.} [Ichidan verb, intransitive verb, Suffix] 6. to be excessive; to be too much; to be too ... {Usually written using kana alone, often used after adjective stems or the -masu stems of verbs}
スクリーン	スクリーン	JLPT N4	[Noun] 1. screen
凄い	すごい	JLPT N4	[I-adjective] 1. terrible; dreadful {Usually written using kana alone} 2. amazing (e.g. of strength); great (e.g. of skills); wonderful; terrific {Usually written using kana alone} 3. to a great extent; vast (in numbers) {Usually written using kana alone} | Other forms: スゴイ、スゴい
進む	すすむ	JLPT N4	[Godan verb with mu ending, intransitive verb] 1. to advance; to go forward 2. to precede; to go ahead (of) 3. to make progress; to improve 4. to deepen; to heighten 5. to be fast (of a clock); to be ahead 6. to do of one's own free will {See also 進んで}
すっかり	すっかり	JLPT N4	[Adverb, Adverb taking the 'to' particle] 1. all; completely; thoroughly {Onomatopoeic or mimetic word}
すっと	すっと	JLPT N4	[Adverb, Suru verb] 1. straight; quickly; directly; all of a sudden {Onomatopoeic or mimetic word, スーッと and すうっと are more emphatic} 2. quietly; gently; softly {Onomatopoeic or mimetic word} [Suru verb] 3. to feel refreshed; to feel satisfied | Other forms: スッと、スーッと、すうっと
ステーキ	ステーキ	JLPT N4	[Noun] 1. steak [Notes] ステーキ: gai1.
捨てる	すてる	JLPT N4	[Ichidan verb, Transitive verb] 1. to throw away; to cast away; to dump; to discard 2. to abandon; to desert; to leave 3. to give up; to resign | Other forms: 棄てる 【すてる】
ステレオ	ステレオ	JLPT N4	[Noun] 1. stereo [Notes] ステレオ: gai1, ichi1.
砂	すな	JLPT N4	[Noun] 1. sand; grit 2. gold dust; silver dust {Only applies to すなご} | Other forms: 沙 【すな】、砂子 【すなご】、沙子 【すなご】、砂 【いさご】、沙 【いさご】、砂子 【いさご】、沙子 【いさご】
滑る	すべる	JLPT N4	[Godan verb with ru ending, intransitive verb] 1. to glide; to slide (e.g. on skis); to slip 2. to fail (an examination); to bomb (when telling a joke) 3. to drop; to go down; to come down; to fall (e.g. in status) | Other forms: 辷る 【すべる】
隅	すみ	JLPT N4	[Noun, Noun - used as a suffix] 1. corner; nook; recess [Noun] 2. downstage right (on a noh stage) {Obscure term, Only applies to 角, See also 目付柱} | Other forms: 角 【すみ】、隅 【すま】
済む	すむ	JLPT N4	[Godan verb with mu ending, intransitive verb] 1. to finish; to end; to be completed 2. to merely result in something less severe than expected 3. to feel at ease 4. to feel unease or guilt for troubling someone; to be sorry {See also すみません, in the negative} | Other forms: 濟む 【すむ】 [Notes] すむ: ichi1, news2, nf38. 済む: ichi1, news2, nf38. すむ: ichi1, news2, nf38. 濟む: Out-dated kanji.
掏摸	すり	JLPT N4	[Noun] 1. pickpocket {Usually written using kana alone} | Other forms: 掏児 【すり】、スリ [Notes] すり: Gikun (meaning as reading) or jukujikun (special kanji reading). すり: Gikun (meaning as reading) or jukujikun (special kanji reading).
すると	すると	JLPT N4	[Conjunction] 1. thereupon; hereupon
生活	せいかつ	JLPT N4	[Noun, Suru verb] 1. living; life (one's daily existence); livelihood
生産	せいさん	JLPT N4	[Noun, Suru verb] 1. production; manufacture
政治	せいじ	JLPT N4	[Noun] 1. politics; government
西洋	せいよう	JLPT N4	[Noun, No-adjective] 1. the west; Western countries
世界	せかい	JLPT N4	[Noun] 1. the world; society; the universe 2. sphere; circle; world [No-adjective] 3. renowned; world-famous; well-known outside of Japan [Noun] 4. realm governed by one Buddha; space {Buddhist term, original meaning}
席	せき	JLPT N4	[Noun] 1. seat 2. location (of a gathering, etc.); place 3. position; post
説明	せつめい	JLPT N4	[Noun, Suru verb, No-adjective] 1. explanation; exposition
背中	せなか	JLPT N4	[Noun] 1. back (of body) | Other forms: 背なか 【せなか】
線	せん	JLPT N4	[Noun, Noun - used as a suffix] 1. line; stripe; stria 2. line (e.g. telephone line); wire 3. ray (e.g. X-ray); beam {See also Ｘ線} 4. line (e.g. of a railroad); track; route; lane 5. outline; contours; form 6. level 7. division 8. line (of action); position; approach; policy; principle {See also いい線} 9. impression one leaves; air one gives off {See also 線が太い, See also 線が細い}
戦争	せんそう	JLPT N4	[Noun, Suru verb] 1. war
先輩	せんぱい	JLPT N4	[Noun] 1. senior (at work or school); superior; elder; older graduate; progenitor; old-timer {See also 後輩 こうはい}
そう	そう	JLPT N4	[Adverb] 1. so; really; seeming [Na-adjective, Suffix] 2. appearing that; seeming that; looking like; having the appearance of {after masu stem or adj-stem}
育てる	そだてる	JLPT N4	[Ichidan verb, Transitive verb] 1. to raise; to rear; to bring up 2. to train; to teach; to educate 3. to promote the growth of; to nurture; to foster; to develop
卒業	そつぎょう	JLPT N4	[Noun, Suru verb, No-adjective] 1. graduation; completion (e.g. of a course) 2. outgrowing something; moving on {Colloquialism}
祖父	そふ	JLPT N4	[Noun, No-adjective] 1. grandfather 2. old man {Only applies to おおじ, See also 爺} 3. kyogen mask used for the role of an old man {Only applies to おおじ} [Place] 4. Sofu | Other forms: 祖父 【じじ】、祖父 【じい】、祖父 【おおじ】、祖父 【おじ】、祖父 【そぶ】 [Notes] そぶ: Out-dated or obsolete kana usage.
ソフト	ソフト	JLPT N4	[Na-adjective, No-adjective] 1. soft {Antonym: ハード} [Noun] 2. software {Computer terminology, Abbreviation, See also ソフトウエア} 3. soft hat; felt hat {Abbreviation, See also ソフト帽} 4. soft serve ice cream {Abbreviation, See also ソフトクリーム} 5. softball {Abbreviation, See also ソフトボール} [Wikipedia definition] 6. Soft
祖母	そぼ	JLPT N4	[Noun, No-adjective] 1. grandmother {See also 婆} | Other forms: 祖母 【ばば】、祖母 【おおば】、祖母 【おば】、祖母 【うば】
其れで	それで	JLPT N4	[Conjunction] 1. and; thereupon; because of that {Usually written using kana alone}
其れに	それに	JLPT N4	[Conjunction] 1. besides; in addition; also; moreover {Usually written using kana alone}
それ程	それほど	JLPT N4	[Adverb] 1. to that degree; to that extent; that much {Usually written using kana alone} | Other forms: 其れ程 【それほど】、其程 【それほど】
そろそろ	そろそろ	JLPT N4	[Adverb, Adverb taking the 'to' particle] 1. slowly; quietly; steadily; gradually; gingerly {Onomatopoeic or mimetic word, Only applies to そろそろ, Only applies to ソロソロ} [Adverb] 2. soon; momentarily; before long; any time now {Onomatopoeic or mimetic word} | Other forms: ソロソロ、そろっと、ソロっと、ソロッと
そんな	そんな	JLPT N4	[Pre-noun adjectival] 1. such (about the actions of the listener, or about ideas expressed or understood by the listener); like that; that sort of {See also あんな, See also こんな, See also どんな}
そんなに	そんなに	JLPT N4	[Expression] 1. so much; so; like that
退院	たいいん	JLPT N4	[Noun, Suru verb] 1. leaving hospital; discharge from hospital
大学生	だいがくせい	JLPT N4	[Noun] 1. university student; college student
大事	だいじ	JLPT N4	[Na-adjective, Noun] 1. important; valuable; serious matter 2. safe (Tochigi dialect); OK {Only applies to だいじ, See also だいじょうぶ} | Other forms: 大事 【おおごと】
大体	だいたい	JLPT N4	[Noun] 1. outline; main point; gist {Usually written using kana alone} [Adverbial noun, Temporal noun] 2. general; substantially; approximately; about {Usually written using kana alone} 3. in the first place; to begin with; from the start {Usually written using kana alone}
大抵	たいてい	JLPT N4	[Na-adjective, Adverb, Noun] 1. mostly; ordinarily; usually; generally {Usually written using kana alone} 2. probably [No-adjective, Noun] 3. most; almost all 4. ordinary {before a neg. form} [Na-adjective] 5. proper; appropriate; moderate {usu. as 〜にする} | Other forms: 大てい 【たいてい】
タイプ	タイプ	JLPT N4	[Noun, Suru verb] 1. type; kind; sort; style 2. typewriter; typing {Abbreviation, See also タイプライター}
大分	だいぶ	JLPT N4	[Adverb] 1. considerably; greatly; a lot {Usually written using kana alone} [Place] 2. Daibu [Wikipedia definition] 3. Oita | Other forms: 大分 【だいぶん】
台風	たいふう	JLPT N4	[Noun] 1. typhoon; hurricane | Other forms: 颱風 【たいふう】
倒れる	たおれる	JLPT N4	[Ichidan verb, intransitive verb] 1. to fall; to collapse; to drop; to fall senseless {Only applies to 倒れる, See also 崩れる, See also 倒す たおす} 2. to be forced to bed (by illness, etc.) 3. to die 4. to go bankrupt; to be ruined; to have a bad debt 5. to be defeated (in a game) 6. to fall (of governments, dictators, etc.) | Other forms: 斃れる 【たおれる】、仆れる 【たおれる】、殪れる 【たおれる】
だから	だから	JLPT N4	[Conjunction] 1. so; therefore {See also ですから}
確か	たしか	JLPT N4	[Na-adjective, Noun] 1. sure; certain; positive; definite 2. reliable; trustworthy; safe; sound; firm; accurate; correct; exact [Adverb] 3. If I'm not mistaken; If I remember correctly; If I remember rightly | Other forms: 確 【たしか】、慥か 【たしか】 [Notes] 確: Irregular okurigana usage.
足す	たす	JLPT N4	[Godan verb with su ending, Transitive verb] 1. to add (numbers) 2. to add (something); to top up (with something) 3. to take care of (e.g. one's business) {See also 用を足す}
尋ねる	たずねる	JLPT N4	[Ichidan verb, Transitive verb] 1. to ask; to enquire; to inquire 2. to search; to look for; to look into; to investigate | Other forms: 訊ねる 【たずねる】
訪ねる	たずねる	JLPT N4	[Ichidan verb, Transitive verb] 1. to visit; to call on; to pay a visit to
正しい	ただしい	JLPT N4	[I-adjective] 1. right; correct 2. proper; righteous; just; honest; truthful; lawful
畳	たたみ	JLPT N4	[Noun] 1. tatami mat; Japanese straw floor coverings | Other forms: 疊 【たたみ】 [Notes] 疊: Out-dated kanji.
建てる	たてる	JLPT N4	[Ichidan verb, Transitive verb] 1. to build; to construct
立てる	たてる	JLPT N4	[Ichidan verb, Transitive verb] 1. to stand up; to put up; to set up; to erect; to raise {also written as 起てる} 2. to thrust into; to bury into; to dig into 3. to make (a noise); to start (a rumour); to raise (a cloud of dust, etc.); to cause 4. to make; to establish; to set up; to develop; to formulate 5. to put up (a political candidate); to make (one's leader) 6. to treat with respect; to give (someone) their due; to make (someone) look good; to avoid embarrassing (someone) 7. to sharpen; to make clear 8. to shut; to close {See also 閉てる} 9. to make tea (matcha); to perform the tea ceremony {See also 点てる} 10. to divide by [Suffix, Ichidan verb] 11. to do ... vigorously {after the -masu stem of a verb}
例えば	たとえば	JLPT N4	[Adverb] 1. for example; for instance; e.g.
棚	たな	JLPT N4	[Noun] 1. shelf; shelves; ledge; rack 2. trellis
楽しみ	たのしみ	JLPT N4	[Na-adjective, Noun] 1. enjoyment; pleasure; diversion; amusement; hobby {See also 御楽しみ} 2. anticipation; looking forward to {See also 楽しみにする} | Other forms: 愉しみ 【たのしみ】
楽しむ	たのしむ	JLPT N4	[Godan verb with mu ending] 1. to enjoy (oneself) | Other forms: 愉しむ 【たのしむ】、楽む 【たのしむ】 [Notes] 楽む: Irregular okurigana usage.
偶に	たまに	JLPT N4	[Adverb, Suffix] 1. occasionally; once in a while {Usually written using kana alone} | Other forms: 適に 【たまに】
為	ため	JLPT N4	[Noun] 1. good; advantage; benefit; welfare {Usually written using kana alone, See also 為に} 2. sake; purpose; objective; aim {Usually written using kana alone} 3. consequence; result; effect {Usually written using kana alone} 4. affecting; regarding; concerning {Usually written using kana alone} | Other forms: 爲 【ため】、為め 【ため】 [Notes] 爲: Out-dated kanji. 為め: Irregular okurigana usage.
足りる	たりる	JLPT N4	[Ichidan verb, intransitive verb] 1. to be sufficient; to be enough {See also 取るに足りない, in the form verb に足りる} 2. to be worth doing; to be worthy 3. to be sufficient; to answer; to do
男性	だんせい	JLPT N4	[Noun, No-adjective] 1. man; male 2. masculine gender {linguistics terminology}
暖房	だんぼう	JLPT N4	[Noun, Suru verb] 1. (indoor) heating {Antonym: 冷房} | Other forms: 煖房 【だんぼう】
血	ち	JLPT N4	[Noun] 1. blood; consanguinity
チェック	チェック	JLPT N4	[Noun, No-adjective] 1. check; plaid; checkered [Noun, Suru verb] 2. checking; monitoring; looking over; scrutinizing; inspecting [Noun] 3. check (banking); cheque; bill (restaurant) 4. check (chess) [Wikipedia definition] 5. Check
力	ちから	JLPT N4	[Noun] 1. force; strength; might; vigour (vigor); energy 2. capability; ability; proficiency; capacity; faculty 3. efficacy; effect 4. effort; endeavours (endeavors); exertions 5. power; authority; influence; good offices; agency 6. support; help; aid; assistance {See also 力になる} 7. stress; emphasis 8. means; resources
些とも	ちっとも	JLPT N4	[Adverb] 1. not at all (neg. verb) {Usually written using kana alone} [Notes] ちっとも: ichi1. 些とも: ichi1.
ちゃん	ちゃん	JLPT N4	[Suffix] 1. suffix for familiar person {Familiar language}
注意	ちゅうい	JLPT N4	[Noun, Suru verb] 1. caution; being careful; attention (heed); warning; advice {See also ご注意}
中学校	ちゅうがっこう	JLPT N4	[Noun] 1. junior high school; middle school; lower secondary school
注射	ちゅうしゃ	JLPT N4	[Noun, Suru verb] 1. injection
駐車場	ちゅうしゃじょう	JLPT N4	[Noun] 1. parking lot; parking place
地理	ちり	JLPT N4	[Noun] 1. geography
捕まえる	つかまえる	JLPT N4	[Ichidan verb, Transitive verb] 1. to catch; to arrest; to seize | Other forms: 捉まえる 【つかまえる】、掴まえる 【つかまえる】
付く	つく	JLPT N4	[Godan verb with ku ending, intransitive verb] 1. to be attached; to be connected with; to adhere; to stick; to cling 2. to remain imprinted; to scar; to stain; to dye 3. to bear (fruit, interest, etc.) 4. to be acquired (of a habit, ability, etc.); to increase (of strength, etc.) 5. to take root 6. to accompany; to attend; to follow; to study with 7. to side with; to belong to 8. to possess; to haunt {See also 憑く} 9. to be lit; to be lighted {See also 点く} 10. to be settled; to be resolved; to be decided 11. to be given (of a name, price, etc.) 12. to be sensed; to be perceived 13. to be lucky {from 運がつく} [Suffix, Godan verb with ku ending] 14. to become (a state, condition, etc.) {See also 付く づく, after -masu stems, onomatopoeic and mimetic words}
漬ける	つける	JLPT N4	[Ichidan verb, Transitive verb] 1. to soak; to seep; to dip in 2. to pickle {Only applies to 漬ける} | Other forms: 浸ける 【つける】
都合	つごう	JLPT N4	[Adverb, Noun] 1. circumstances; condition; convenience [Suru verb] 2. to arrange; to manage 3. to lend money; to raise money [Adverb] 4. in all; in total; all told
伝える	つたえる	JLPT N4	[Ichidan verb, Transitive verb] 1. to convey; to report; to transmit; to communicate; to tell; to impart; to propagate; to teach; to bequeath
続く	つづく	JLPT N4	[Godan verb with ku ending, intransitive verb] 1. to continue; to last; to go on 2. to continue (without a break); to be unbroken 3. to occur again and again 4. to lead to; to connect to; to adjoin 5. to come after; to follow; to succeed; to rank next to 6. to hold out; to keep; to last
続ける	つづける	JLPT N4	[Ichidan verb, Transitive verb, Auxiliary verb] 1. to continue; to keep up; to keep on
包む	つつむ	JLPT N4	[Godan verb with mu ending, Transitive verb] 1. to wrap up; to tuck in; to pack; to do up; to cover with; to dress in [Godan verb with mu ending] 2. to conceal; to hide; to be engulfed in; to be enveloped by | Other forms: 裹む 【つつむ】 [Notes] 裹む: Out-dated kanji.
妻	つま	JLPT N4	[Noun] 1. wife {Only applies to 妻} 2. my dear; dear; honey {Archaism, Only applies to 妻, Only applies to 夫} 3. garnish (esp. one served with sashimi) {Usually written using kana alone} 4. embellishment {Usually written using kana alone} | Other forms: 夫 【つま】、具 【つま】
端	つま	JLPT N4	[Noun] 1. edge; tip; end 2. gable wall {See also 妻壁} 3. gable {See also 切妻} | Other forms: 妻 【つま】
積もり	つもり	JLPT N4	[Noun] 1. intention; plan {Usually written using kana alone} 2. conviction; belief {Usually written using kana alone} | Other forms: 積り 【つもり】
釣る	つる	JLPT N4	[Godan verb with ru ending, Transitive verb] 1. to fish; to angle; to catch 2. to lure in; to tempt; to attract; to entice; to allure {See also 釣られる}
丁寧	ていねい	JLPT N4	[Na-adjective, Noun] 1. polite; courteous; civil 2. careful; close; thorough; conscientious | Other forms: 叮嚀 【ていねい】
テキスト	テキスト	JLPT N4	[Noun] 1. text 2. textbook | Other forms: テクスト
適当	てきとう	JLPT N4	[Na-adjective, Noun] 1. suitable; proper; appropriate; adequate; fit 2. noncommittal; vague; equivocal; unserious; irresponsible
手伝う	てつだう	JLPT N4	[Godan verb with u ending, Transitive verb] 1. to help; to assist; to aid 2. to contribute to; to be a factor in | Other forms: 手つだう 【てつだう】
テニス	テニス	JLPT N4	[Noun] 1. tennis [Notes] テニス: gai1, ichi1.
手袋	てぶくろ	JLPT N4	[Noun] 1. glove; mitten; mitt | Other forms: 手ぶくろ 【てぶくろ】
寺	てら	JLPT N4	[Noun] 1. temple (Buddhist)
点	てん	JLPT N4	[Noun, Noun - used as a suffix] 1. spot; mark 2. point; dot 3. mark (e.g. in exam); score; points [Noun] 4. comma 5. aspect; matter; respect [Counter] 6. counter for goods, items, articles of clothing, works of art, etc.
店員	てんいん	JLPT N4	[Noun, No-adjective] 1. shop assistant; employee; clerk; salesperson
天気予報	てんきよほう	JLPT N4	[Noun] 1. weather forecast; weather report
電灯	でんとう	JLPT N4	[Noun] 1. electric light | Other forms: 電燈 【でんとう】 [Notes] 電燈: Out-dated kanji.
電報	でんぽう	JLPT N4	[Noun] 1. telegram
展覧会	てんらんかい	JLPT N4	[Noun] 1. exhibition
都	と	JLPT N4	[Noun, No-adjective] 1. metropolitan; municipal
道具	どうぐ	JLPT N4	[Noun] 1. tool; implement; instrument; utensil; apparatus; device 2. means
到頭	とうとう	JLPT N4	[Adverb] 1. finally; at last; ultimately; in the end {Usually written using kana alone}
動物園	どうぶつえん	JLPT N4	[Noun] 1. zoo; zoological gardens [Place] 2. Doubutsuen
遠く	とおく	JLPT N4	[No-adjective, Adverbial noun, Noun] 1. far away; distant; at a distance; distant place; by far
通る	とおる	JLPT N4	[Godan verb with ru ending, intransitive verb] 1. to go by; to go past; to go along; to travel along; to pass through; to use (a road); to take (a route); to go via; to go by way of 2. to run (between); to operate (between); to connect {of public transport} 3. to go indoors; to go into a room; to be admitted; to be shown in; to be ushered in; to come in 4. to penetrate; to pierce; to skewer; to go through; to come through 5. to permeate; to soak into; to spread throughout 6. to carry (e.g. of a voice); to reach far 7. to be passed on (e.g. of a customer's order to the kitchen); to be relayed; to be conveyed 8. to pass (a test, a bill in the House, etc.); to be approved; to be accepted 9. to go by (a name); to be known as; to be accepted as; to have a reputation for 10. to be coherent; to be logical; to be reasonable; to be comprehensible; to be understandable; to make sense 11. to get across (e.g. of one's point); to be understood 12. to be straight (e.g. wood grain) 13. to be well-informed; to be wise {Archaism} [Suffix, Godan verb with ru ending] 14. to do ... completely; to do ... thoroughly {after the -masu stem of a verb} | Other forms: 徹る 【とおる】、透る 【とおる】
特に	とくに	JLPT N4	[Adverb] 1. particularly; especially
特別	とくべつ	JLPT N4	[Na-adjective, Adverb, Noun, No-adjective] 1. special
床屋	とこや	JLPT N4	[Noun] 1. barbershop; barber
途中	とちゅう	JLPT N4	[Adverbial noun, Temporal noun] 1. on the way; en route 2. in the middle of; midway
特急	とっきゅう	JLPT N4	[Noun] 1. limited express (train, faster than an express) {Abbreviation, See also 特別急行} 2. great hurry
届ける	とどける	JLPT N4	[Ichidan verb, Transitive verb] 1. to deliver; to forward; to send 2. to report; to notify; to file notice (to the authorities); to give notice; to register | Other forms: 屆ける 【とどける】 [Notes] 屆ける: Out-dated kanji.
泊まる	とまる	JLPT N4	[Godan verb with ru ending, intransitive verb] 1. to stay at (e.g. hotel) 2. to be docked; to be berthed; to be moored | Other forms: 泊る 【とまる】
止める	とめる	JLPT N4	[Ichidan verb, Transitive verb] 1. to stop; to turn off {esp. 止める, 停める} 2. to park {esp. 止める, 停める} 3. to prevent; to suppress (a cough); to hold back (tears); to hold (one's breath); to relieve (pain) {esp. 止める, 停める} 4. to stop (someone from doing something); to dissuade; to forbid; to prohibit 5. to notice; to be aware of; to concentrate on; to pay attention to; to remember; to bear in mind {See also 目を留める, See also 気に留める} 6. to fix (in place); to fasten; to tack; to pin; to nail; to button; to staple {esp. 留める} 7. to detain; to keep in custody {esp. 留める} | Other forms: 留める 【とめる】、停める 【とめる】
取り替える	とりかえる	JLPT N4	[Ichidan verb, Transitive verb] 1. to exchange; to replace | Other forms: 取換える 【とりかえる】、取り換える 【とりかえる】、取替える 【とりかえる】、取りかえる 【とりかえる】、取換る 【とりかえる】 [Notes] 取換る: Irregular okurigana usage.
泥棒	どろぼう	JLPT N4	[Noun, Suru verb] 1. thief; burglar; robber; theft | Other forms: 泥坊 【どろぼう】
どんどん	どんどん	JLPT N4	[Adverb taking the 'to' particle, Adverb] 1. drumming (noise) {Onomatopoeic or mimetic word} 2. rapidly; steadily
治す	なおす	JLPT N4	[Godan verb with su ending, Transitive verb] 1. to cure; to heal {usu. 治す} 2. to fix; to correct; to repair {usu. 直す} [Auxiliary verb] 3. to do over again (after -masu base of verb) {usu. 直す} 4. to replace; to put back as it was {Kansai dialect, usu. 直す} 5. to convert (into a different state); to transform {usu. 直す} | Other forms: 直す 【なおす】
治る	なおる	JLPT N4	[Godan verb with ru ending, intransitive verb] 1. to be cured; to get well; to be healed {esp. 治る} 2. to get mended; to be repaired; to be fixed {esp. 直る} | Other forms: 直る 【なおる】
泣く	なく	JLPT N4	[Godan verb with ku ending] 1. to cry; to weep; to sob; to howl | Other forms: 哭く 【なく】 [Notes] 哭く: Irregular kanji usage.
亡くなる	なくなる	JLPT N4	[Godan verb with ru ending, intransitive verb] 1. to die
無くなる	なくなる	JLPT N4	[Godan verb with ru ending, intransitive verb] 1. to be lost (e.g. luggage); to be missing {Usually written using kana alone} 2. to be used up; to be run out; to be exhausted; to be consumed; to be reduced to zero; to not occur any more {Usually written using kana alone} 3. to disappear (e.g. pain); to be lost (e.g. a dream, confidence) {Usually written using kana alone}
投げる	なげる	JLPT N4	[Ichidan verb, Transitive verb] 1. to throw; to cast away 2. to face defeat; to give up
為さる	なさる	JLPT N4	[Godan verb - aru special class, Transitive verb] 1. to do {Honorific or respectful (sonkeigo), Usually written using kana alone}
鳴る	なる	JLPT N4	[Godan verb with ru ending, intransitive verb] 1. to sound; to ring; to resound; to echo; to roar; to rumble
成るべく	なるべく	JLPT N4	[Adverb] 1. as much as possible; wherever practicable {Usually written using kana alone} | Other forms: 成る可く 【なるべく】
なる程	なるほど	JLPT N4	[Expression, Adverb] 1. I see; That's right!; Indeed {Usually written using kana alone} | Other forms: 成る程 【なるほど】、成程 【なるほど】、成るほど 【なるほど】、ナルホド
慣れる	なれる	JLPT N4	[Ichidan verb, intransitive verb] 1. to get used to; to grow accustomed to; to become familiar with {esp. 慣れる} 2. to become skilled in; to become experienced at {esp. 慣れる} 3. to become tame; to become domesticated {esp. 馴れる} | Other forms: 馴れる 【なれる】
苦い	にがい	JLPT N4	[I-adjective] 1. bitter
二階建て	にかいだて	JLPT N4	[Noun] 1. two-storied building | Other forms: 二階建 【にかいだて】
逃げる	にげる	JLPT N4	[Ichidan verb, intransitive verb] 1. to escape; to run away | Other forms: 迯げる 【にげる】 [Notes] 迯げる: Out-dated kanji.
日記	にっき	JLPT N4	[Noun] 1. diary; journal
入院	にゅういん	JLPT N4	[Noun, Suru verb] 1. hospitalization; hospitalisation
入学	にゅうがく	JLPT N4	[Noun, Suru verb] 1. entry to school or university; matriculation; enrolment (in university, etc.)
似る	にる	JLPT N4	[Ichidan verb, intransitive verb] 1. to resemble; to look like; to take after 2. to be similar (in status, condition, etc.); to be close; to be alike; to be like
人形	にんぎょう	JLPT N4	[Noun] 1. doll; puppet; figure [Place] 2. Ningyou
盗む	ぬすむ	JLPT N4	[Godan verb with mu ending, Transitive verb] 1. to steal | Other forms: 偸む 【ぬすむ】
塗る	ぬる	JLPT N4	[Godan verb with ru ending, Transitive verb] 1. to paint; to plaster; to lacquer; to varnish; to spread; to smear; to put up (wallpaper)
濡れる	ぬれる	JLPT N4	[Ichidan verb, intransitive verb] 1. to get wet | Other forms: 濡る 【ぬれる】 [Notes] 濡る: Irregular okurigana usage.
値段	ねだん	JLPT N4	[Noun] 1. price; cost | Other forms: 直段 【ねだん】
熱	ねつ	JLPT N4	[Noun] 1. heat 2. fever; temperature 3. zeal; passion; enthusiasm 4. mania; craze; rage
寝坊	ねぼう	JLPT N4	[Noun, Suru verb] 1. sleeping in late; oversleeping [Noun] 2. late riser; sleepyhead | Other forms: 寐坊 【ねぼう】 [Notes] 寐坊: Out-dated kanji.
眠い	ねむい	JLPT N4	[I-adjective] 1. sleepy; drowsy; somnolent | Other forms: 睡い 【ねむい】
眠る	ねむる	JLPT N4	[Godan verb with ru ending, intransitive verb] 1. to sleep (not necessarily lying down) {See also 寝る} 2. to die 3. to lie idle (e.g. of resources); to be dormant; to be unused {Only applies to ねむる} 4. to close one's eyes {Archaism} | Other forms: 眠る 【ねぶる】、睡る 【ねむる】、睡る 【ねぶる】 [Notes] ねぶる: Out-dated or obsolete kana usage. ねぶる: Out-dated or obsolete kana usage.
残る	のこる	JLPT N4	[Godan verb with ru ending, intransitive verb] 1. to remain; to be left | Other forms: 遺る 【のこる】
乗り換える	のりかえる	JLPT N4	[Ichidan verb, Transitive verb] 1. to transfer (trains); to change (bus, train) 2. to change one's mind; to move on to (e.g. a new love interest); to change methods; to change one's way of thinking | Other forms: 乗り替える 【のりかえる】、乗りかえる 【のりかえる】
乗り物	のりもの	JLPT N4	[Noun] 1. vehicle; conveyance; transport 2. ride (playground, fair, carnival); playground facility | Other forms: 乗物 【のりもの】
葉	は	JLPT N4	[Noun] 1. leaf
パート	パート	JLPT N4	[Noun] 1. part 2. part-timer {Abbreviation, See also パートタイマー} 3. part-time (work) {Abbreviation, See also パートタイム} [Wikipedia definition] 4. Part
場合	ばあい	JLPT N4	[Adverbial noun, Noun] 1. case; situation
倍	ばい	JLPT N4	[Noun] 1. twice; double [Suffix] 2. times; -fold
拝見	はいけん	JLPT N4	[Noun, Suru verb] 1. seeing; look at {Humble (kenjougo), Polite (teineigo)} | Other forms: 拜見 【はいけん】 [Notes] 拜見: Out-dated kanji.
歯医者	はいしゃ	JLPT N4	[Noun] 1. dentist
運ぶ	はこぶ	JLPT N4	[Godan verb with bu ending, Transitive verb] 1. to carry; to transport; to move; to convey [Godan verb with bu ending] 2. to come; to go {Honorific or respectful (sonkeigo), See also 足を運ぶ, usu. as お運びになる, お運び下さる, etc.} [Godan verb with bu ending, Transitive verb] 3. to wield (a tool, etc.); to use [Godan verb with bu ending, intransitive verb] 4. to go (well, etc.); to proceed; to progress
始める	はじめる	JLPT N4	[Ichidan verb, Transitive verb] 1. to start; to begin; to commence; to initiate; to originate 2. to open (e.g. a store); to start up; to establish (business. etc.) [Auxiliary verb, Ichidan verb] 3. to start ...; to begin to ... {See also 為始める, after the -masu stem of a verb} | Other forms: 創める 【はじめる】
場所	ばしょ	JLPT N4	[Noun] 1. place; location; spot; position 2. room; space 3. basho; wrestling tournament {Sumo term}
筈	はず	JLPT N4	[Noun] 1. expectation that something took place, will take place or was in some state; it should be so; bound to be; expected to be; must be {Usually written using kana alone} 2. nock (of a bow) 3. nock (of an arrow) 4. nock-shaped grip (between thumb and forefinger) {Sumo term, See also はず押し はずおし} 5. wooden frame on the tip of the mast of a Japanese ship that prevents the hawser from falling out | Other forms: 弭 【はず】
恥ずかしい	はずかしい	JLPT N4	[I-adjective] 1. shy; ashamed; embarrassed {See also 気恥ずかしい, See also 小っ恥ずかしい} 2. disgraceful; shameful | Other forms: 羞ずかしい 【はずかしい】
パソコン	パソコン	JLPT N4	[Noun, No-adjective] 1. personal computer {Computer terminology, Abbreviation}
発音	はつおん	JLPT N4	[Noun, Suru verb, No-adjective] 1. pronunciation
はっきり	はっきり	JLPT N4	[Adverb, Adverb taking the 'to' particle] 1. clearly; plainly; distinctly {Onomatopoeic or mimetic word} [Suru verb] 2. to be clear; to be definite; to be certain; to be exact; to become clear; to clear up {often as はっきりした} | Other forms: ハッキリ
花見	はなみ	JLPT N4	[Noun, Suru verb] 1. cherry blossom viewing; flower viewing
林	はやし	JLPT N4	[Noun] 1. woods; forest; copse; thicket 2. bunch; line (of something); collection [Wikipedia definition] 3. Hayashi
払う	はらう	JLPT N4	[Godan verb with u ending, Transitive verb] 1. to pay (e.g. money, bill) 2. to brush off; to wipe away; to clear away; to dust off; to cut off (e.g. branches) 3. to drive away (e.g. one's competitors) 4. to sell off (something unneeded); to dispose of 5. to pay (e.g. attention); to show (e.g. respect, concern) 6. to make (e.g. effort, sacrifice); to expend; to exert 7. to move out (of one's own place); to vacate 8. to sweep (e.g. one's legs); to knock aside 9. to make a sweeping stroke (in Japanese calligraphy) 10. to reset (an abacus)
番組	ばんぐみ	JLPT N4	[Noun] 1. program (e.g. TV); programme [Place] 2. Bangumi
反対	はんたい	JLPT N4	[Na-adjective, Noun, Suru verb, No-adjective] 1. opposition; resistance; antagonism; hostility; objection; dissension [Noun, Suru verb] 2. reverse; opposite; vice versa; contrast
ハンドバッグ	ハンドバッグ	JLPT N4	[Noun] 1. handbag; purse [Notes] ハンドバッグ: gai1, ichi1.
日	ひ	JLPT N4	[Adverbial noun, Temporal noun] 1. day; days {Only applies to 日} 2. sun; sunshine; sunlight 3. case (esp. unfortunate); event {Only applies to 日, as 〜した日には, 〜と来た日には, etc.} [Place] 4. Hi | Other forms: 陽 【ひ】
火	ひ	JLPT N4	[Noun, Noun - used as a suffix] 1. fire; flame; blaze
ピアノ	ピアノ	JLPT N4	[Noun] 1. piano | Other forms: ピヤノ [Notes] ピアノ: gai1, ichi1.
冷える	ひえる	JLPT N4	[Ichidan verb, intransitive verb] 1. to grow cold (from room temperature, e.g. in refrigerator); to get chilly; to cool down
光	ひかり	JLPT N4	[Noun] 1. light
光	ひかり	JLPT N4	[Noun] 1. light
光る	ひかる	JLPT N4	[Godan verb with ru ending, intransitive verb] 1. to shine; to glitter; to be bright
引き出し	ひきだし	JLPT N4	[Noun] 1. drawer 2. withdrawal; drawing out {not 抽斗,抽匣} 3. variety of knowledge and experience useful for handling things impromptu {not 抽斗,抽匣} | Other forms: 引出し 【ひきだし】、抽き出し 【ひきだし】、抽出し 【ひきだし】、抽斗 【ひきだし】、抽匣 【ひきだし】 [Notes] 抽斗: Out-dated kanji.
引き出す	ひきだす	JLPT N4	[Godan verb with su ending, Transitive verb] 1. to pull out; to take out; to draw out; to withdraw | Other forms: 引出す 【ひきだす】、引きだす 【ひきだす】
髭	ひげ	JLPT N4	[Noun] 1. moustache; beard; whiskers {Usually written using kana alone, See also 口髭, See also 顎鬚, See also 頬髯, in careful usage 髭 for moustache, 鬚 for beard, 髯 for (cheek) whiskers} 2. extremely short pulse appearing on an electrical signal | Other forms: 鬚 【ひげ】、髯 【ひげ】、ヒゲ
飛行場	ひこうじょう	JLPT N4	[Noun] 1. airfield; airport [Place] 2. Hikoujou
久しぶり	ひさしぶり	JLPT N4	[Na-adjective, No-adjective] 1. a long time (since the last time); it's been a while (since I last saw, mailed, etc., you) | Other forms: 久し振り 【ひさしぶり】
美術館	びじゅつかん	JLPT N4	[Noun] 1. art gallery; art museum [Place] 2. Bijutsukan
非常に	ひじょうに	JLPT N4	[Adverb] 1. very; extremely; exceedingly {See also 非常}
引っ越す	ひっこす	JLPT N4	[Godan verb with su ending, intransitive verb] 1. to move (house); to change residence | Other forms: 引っこす 【ひっこす】、引越す 【ひきこす】、引き越す 【ひきこす】 [Notes] 引越す: Irregular okurigana usage.
必要	ひつよう	JLPT N4	[Na-adjective] 1. necessary; needed; essential; indispensable {必用 can imply has to be used rather than is just needed} [Noun] 2. necessity; need; requirement | Other forms: 必用 【ひつよう】
酷い	ひどい	JLPT N4	[I-adjective] 1. cruel; heartless; hard; harsh; severe {Usually written using kana alone} 2. violent; intense; strong; heavy; extreme {Usually written using kana alone} 3. very bad; terrible; awful {Usually written using kana alone} 4. excessive; exorbitant; unreasonable; outrageous; unfair; unjust {Usually written using kana alone, See also 酷く} | Other forms: 非道い 【ひどい】
開く	ひらく	JLPT N4	[Godan verb with ku ending, intransitive verb, Transitive verb] 1. to open; to undo; to unseal; to unpack 2. to bloom; to unfold; to spread out 3. to open (for business, e.g. in the morning) 4. to be wide (gap, etc.); to widen [Godan verb with ku ending, Transitive verb] 5. to hold (meeting, etc.); to give; to open 6. to found (nation, dynasty, sect, etc.); to open (a new business); to set up; to establish; to start 7. to open (ports, borders, etc.) 8. to open (an account) 9. to open up (new land, path, etc.); to clear; to develop {See also 拓く} 10. to open (a file, etc.) {Computer terminology} 11. to extract (root); to reduce (equation) {Mathematics} 12. to cut open (fish) {Food term, as 魚を開く} 13. to change (kanji into hiragana) [Godan verb with ku ending, intransitive verb] 14. to flare (e.g. skirt) 15. to slacken (into a poor posture) {Sports term, as 体が開く, 肩が開く, etc.}
ビル	ビル	JLPT N4	[Noun] 1. multi-floor building; multi-storey building {Abbreviation, See also ビルディング} 2. bill [Wikipedia definition] 3. Bill
昼間	ひるま	JLPT N4	[Adverbial noun, Temporal noun] 1. daytime; during the day; time from sunrise until sunset; diurnal period | Other forms: 昼間 【ちゅうかん】
昼休み	ひるやすみ	JLPT N4	[Adverbial noun, Temporal noun] 1. lunch break; noon recess; noon rest period
拾う	ひろう	JLPT N4	[Godan verb with u ending, Transitive verb] 1. to pick up; to find; to gather
ファックス	ファックス	JLPT N4	[Noun] 1. facsimile; FAX {See also ファクシミリ}
増える	ふえる	JLPT N4	[Ichidan verb, intransitive verb] 1. to increase; to multiply | Other forms: 殖える 【ふえる】
深い	ふかい	JLPT N4	[I-adjective] 1. deep {Antonym: 浅い} 2. profound 3. dense; thick 4. close (relationship) 5. intense; strong 6. late
複雑	ふくざつ	JLPT N4	[Na-adjective] 1. complex; complicated; mixed (feelings) {See also ややこしい}
復習	ふくしゅう	JLPT N4	[Noun, Suru verb] 1. review; revision
部長	ぶちょう	JLPT N4	[Noun] 1. head (chief, director) of a section or department 2. head of a (school) club; head of a (school) team {See also 倶楽部}
普通	ふつう	JLPT N4	[No-adjective] 1. general; ordinary; usual [Adverb] 2. normally; generally; usually 3. train that stops at every station {Abbreviation, See also 普通列車}
葡萄	ぶどう	JLPT N4	[Noun] 1. grape; grapevine {Usually written using kana alone} [Place] 2. Budou | Other forms: 葡萄 【えび】、ブドウ [Notes] えび: Out-dated or obsolete kana usage.
太る	ふとる	JLPT N4	[Godan verb with ru ending, intransitive verb] 1. to grow fat (stout, plump); to become fat; to gain weight | Other forms: 肥る 【ふとる】
布団	ふとん	JLPT N4	[Noun] 1. futon (quilted Japanese-style mattress laid out on the floor) 2. round cushion used for Zen meditation (traditionally made of woven bulrush leaves) | Other forms: 蒲団 【ふとん】、薄団 【ふとん】 [Notes] 布団: Ateji (phonetic) reading. 薄団: Irregular kanji usage.
船	ふね	JLPT N4	[Noun] 1. ship; boat; watercraft; vessel; steamship {Only applies to 船, Only applies to 舟, 舟 is often small and hand-propelled} 2. tank; tub; vat; trough [Noun - used as a suffix, Counter] 3. counter for boat-shaped containers (e.g. of sashimi) {Only applies to 船, Only applies to 舟} | Other forms: 舟 【ふね】、槽 【ふね】
不便	ふべん	JLPT N4	[Na-adjective, Noun] 1. inconvenience; inexpediency; unhandiness
踏む	ふむ	JLPT N4	[Godan verb with mu ending, Transitive verb] 1. to step on; to tread on 2. to experience; to undergo 3. to estimate; to value; to appraise 4. to rhyme 5. to inherit (the throne, etc.) {Archaism} 6. to follow (rules, morals, principles, etc.) | Other forms: 履む 【ふむ】、践む 【ふむ】
降り出す	ふりだす	JLPT N4	[Godan verb with su ending, intransitive verb] 1. to begin to rain; to begin to snow | Other forms: 降りだす 【ふりだす】
プレゼント	プレゼント	JLPT N4	[Noun] 1. present; gift [Suru verb] 2. to give a present or gift
文化	ぶんか	JLPT N4	[Noun] 1. culture; civilization; civilisation 2. Bunka era (1804.2.11-1818.4.22) [Place] 3. Bunka
文学	ぶんがく	JLPT N4	[Noun] 1. literature
文法	ぶんぽう	JLPT N4	[Noun, No-adjective] 1. grammar; syntax {linguistics terminology}
別	べつ	JLPT N4	[No-adjective, Na-adjective, Noun, Noun - used as a suffix, Noun - used as a prefix] 1. distinction; difference; different; another; particular; separate; extra; exception | Other forms: 別 【べち】 [Notes] べち: Out-dated or obsolete kana usage.
ベル	ベル	JLPT N4	[Noun] 1. bell 2. bel; B {See also デシベル}
変	へん	JLPT N4	[Na-adjective, Noun] 1. strange; odd; peculiar; weird; curious; queer; eccentric; funny; suspicious; fishy 2. unexpected 3. change 4. incident; disturbance; disaster; accident [Noun - used as a prefix] 5. flat {Music term, See also 変ロ短調} | Other forms: 變 【へん】 [Notes] 變: Out-dated kanji.
返事	へんじ	JLPT N4	[Noun, Suru verb] 1. reply; answer; response | Other forms: 返辞 【へんじ】
貿易	ぼうえき	JLPT N4	[Noun, Suru verb] 1. trade (foreign)
法律	ほうりつ	JLPT N4	[Noun, No-adjective] 1. law
僕	ぼく	JLPT N4	[Pronoun, No-adjective] 1. I; me {Male term or language} 2. you {used addressing young children} 3. manservant {See also しもべ}
星	ほし	JLPT N4	[Noun] 1. star; any light-emitting (or reflecting) heavenly body (except for the sun and the moon) 2. offender; perpetrator {Slang, police slang} 3. star point (in go); hoshi; intersection marked with a dot 4. circular symbol (said to be shaped like a shining star) 5. bullseye 6. one's star (out of the nine stars); the star that determines one's fate {See also 九星} 7. small dot; spot 8. point; score {Sumo term}
殆ど	ほとんど	JLPT N4	[Adverbial noun, Temporal noun] 1. mostly; nearly; practically; well-nigh; almost invariably; all but; just about; almost {Usually written using kana alone} | Other forms: 殆んど 【ほとんど】、幾ど 【ほとんど】 [Notes] 殆んど: Irregular okurigana usage.
褒める	ほめる	JLPT N4	[Ichidan verb, Transitive verb] 1. to praise; to admire; to speak well of someone | Other forms: 誉める 【ほめる】、賞める 【ほめる】、称める 【ほめる】
翻訳	ほんやく	JLPT N4	[Noun, Suru verb] 1. translation 2. de-encryption; deciphering 3. rendering | Other forms: 飜訳 【ほんやく】
参る	まいる	JLPT N4	[Godan verb with ru ending, intransitive verb] 1. to go; to come; to call {Humble (kenjougo), Usually written using kana alone} 2. to be defeated; to collapse; to die 3. to be annoyed; to be nonplussed 4. to be madly in love 5. to visit (shrine, grave) {See also 墓参り} | Other forms: 詣る 【まいる】
負ける	まける	JLPT N4	[Ichidan verb, intransitive verb] 1. to lose; to be defeated 2. to succumb; to give in; to surrender; to yield {Only applies to 負ける} 3. to be inferior to {Only applies to 負ける} 4. to break out in a rash due to (e.g. lacquer, shaving, etc.) {Only applies to 負ける, See also 気触れる かぶれる} [Ichidan verb, Transitive verb] 5. to reduce the price; to give a discount; to throw in (something extra) for free {Only applies to 負ける} | Other forms: 敗ける 【まける】、敗北る 【まける】 [Notes] 敗北る: Irregular kanji usage.
又は	または	JLPT N4	[Conjunction, Expression] 1. or; otherwise {Usually written using kana alone, See also 又}
間違える	まちがえる	JLPT N4	[Ichidan verb, Transitive verb] 1. to make a mistake (in); to commit an error (e.g. in calculation) 2. to confuse; to mistake something for something else
間に合う	まにあう	JLPT N4	[Godan verb with u ending] 1. to be in time for 2. to serve (suit, meet) the purpose; to be good enough; to be enough | Other forms: 間にあう 【まにあう】、まに合う 【まにあう】
周り	まわり	JLPT N4	[Noun] 1. circumference; girth {See also 回り まわり} 2. surroundings; neighbourhood; neighborhood; vicinity
回る	まわる	JLPT N4	[Godan verb with ru ending, intransitive verb] 1. to turn; to revolve {See also ぐるぐる} 2. to visit several places 3. to function well 4. to pass a certain time | Other forms: 廻る 【まわる】
漫画	まんが	JLPT N4	[Noun] 1. cartoon; comic; comic strip | Other forms: マンガ
真ん中	まんなか	JLPT N4	[Noun] 1. middle; centre; center; mid-way | Other forms: 真中 【まんなか】、まん中 【まんなか】、真中 【まなか】
見える	みえる	JLPT N4	[Ichidan verb, intransitive verb] 1. to be seen; to be in sight 2. to look; to seem; to appear 3. to come {Honorific or respectful (sonkeigo)}
湖	みずうみ	JLPT N4	[Noun] 1. lake
味噌	みそ	JLPT N4	[Noun] 1. miso; fermented condiment usu. made from soybeans {Food term} 2. innards (from crabs, shrimps, etc.) resembling miso 3. key (main) point; good part (of something) {See also 手前味噌 てまえみそ} 4. weakling; weak person {Derogatory, See also 泣き味噌 なきみそ, See also 弱味噌 よわみそ}
見つかる	みつかる	JLPT N4	[Godan verb with ru ending, intransitive verb] 1. to be found; to be discovered | Other forms: 見付かる 【みつかる】
見つける	みつける	JLPT N4	[Ichidan verb, Transitive verb] 1. to discover; to find (e.g. an error in a book); to come across; to detect; to spot 2. to locate; to find (e.g. something missing); to find fault 3. to be used to seeing; to be familiar with {See also 見慣れる} | Other forms: 見付ける 【みつける】、見附ける 【みつける】、見附る 【みつける】、見付ける 【みっける】、見附ける 【みっける】、見附る 【みっける】 [Notes] みつける: ichi1, news2, nf37. 見つける: ichi1, news2, nf37. みつける: ichi1, news2, nf37. 見付ける: ichi1. みつける: ichi1, news2, nf37. みつける: ichi1, news2, nf37. 見附る: Irregular okurigana usage. みっける: Irregular kana usage. 見付ける: ichi1. みっける: Irregular kana usage. みっける: Irregular kana usage. 見附る: Irregular okurigana usage.
港	みなと	JLPT N4	[Noun] 1. harbour; harbor; port | Other forms: 湊 【みなと】
皆	みんな	JLPT N5	[Adverb, Noun] 1. all; everyone; everybody {Usually written using kana alone} 2. everything {Usually written using kana alone} | Other forms: 皆 【みな】
向かう	むかう	JLPT N4	[Godan verb with u ending, intransitive verb] 1. to face 2. to go towards; to head towards | Other forms: 向う 【むかう】、対う 【むかう】
迎える	むかえる	JLPT N4	[Ichidan verb, Transitive verb] 1. to go out to meet 2. to receive; to welcome; to greet; to salute; to hail; to reach; to approach; to enter (a phase, era, etc.) 3. to accept (e.g. as a member of a group or family) 4. to call for; to summon; to invite 5. to approach (a certain time, a point in one's life, etc.) | Other forms: 邀える 【むかえる】
昔	むかし	JLPT N4	[No-adjective, Adverbial noun, Temporal noun] 1. olden days; former
虫	むし	JLPT N4	[Noun] 1. insect; bug; cricket; moth; worm
息子	むすこ	JLPT N4	[Noun] 1. son 2. penis {Vulgar, Only applies to むすこ} | Other forms: むす子 【むすこ】、息 【むすこ】、息 【そく】 [Notes] そく: Out-dated or obsolete kana usage.
娘	むすめ	JLPT N4	[Noun] 1. (my) daughter 2. girl (i.e. a young, unmarried woman) {See also 子 こ}
無理	むり	JLPT N4	[Na-adjective, Noun] 1. unreasonable; unnatural; unjustifiable 2. impossible [Na-adjective, Noun, Suru verb] 3. forcible; forced; compulsory {often as 無理に} [Na-adjective] 4. excessive (work, etc.); immoderate [Suru verb] 5. to work too hard; to try too hard [No-adjective] 6. irrational {Mathematics}
召し上がる	めしあがる	JLPT N4	[Godan verb with ru ending, Transitive verb] 1. to eat; to drink {Honorific or respectful (sonkeigo)} | Other forms: 召しあがる 【めしあがる】、召上がる 【めしあがる】、召し上る 【めしあがる】
珍しい	めずらしい	JLPT N4	[I-adjective] 1. unusual; rare; curious 2. new; novel 3. fine (e.g. gift) | Other forms: 珍らしい 【めずらしい】 [Notes] 珍らしい: Irregular okurigana usage.
申し上げる	もうしあげる	JLPT N4	[Ichidan verb, Transitive verb] 1. to say; to tell; to state; to express; to offer; to extend (greetings, congratulations, etc.) {Humble (kenjougo)} [Auxiliary verb] 2. to do {Humble (kenjougo)} | Other forms: 申上げる 【もうしあげる】、申しあげる 【もうしあげる】
申す	もうす	JLPT N4	[Godan verb with su ending, Transitive verb] 1. to say; to be called {Humble (kenjougo)} 2. to do {Humble (kenjougo), after a word beginning with お- or ご-}
もう直ぐ	もうすぐ	JLPT N4	[Expression] 1. very soon {Usually written using kana alone}
若し	もし	JLPT N4	[Adverb] 1. if; in case; supposing {Usually written using kana alone}
戻る	もどる	JLPT N4	[Godan verb with ru ending, intransitive verb] 1. to turn back (e.g. half-way) 2. to return; to go back 3. to recover (e.g. something lost); to be returned 4. to rebound; to spring back
木綿	もめん	JLPT N4	[Noun] 1. cotton (material) 2. red silk-cotton tree (Bombax ceiba) {Usually written using kana alone, Only applies to きわた, See also パンヤの木} | Other forms: 木綿 【きわた】、木棉 【きわた】
森	もり	JLPT N4	[Noun] 1. forest 2. shrine grove {See also 鎮守の杜, esp. 杜} [Wikipedia definition] 3. Mori | Other forms: 杜 【もり】
焼く	やく	JLPT N4	[Godan verb with ku ending, Transitive verb] 1. to burn 2. to roast; to broil; to grill; to bake; to toast; to barbecue 3. to heat; to heat up 4. to make (charcoal, pottery, bricks, etc.); to bake; to fire; to burn 5. to tan (i.e. suntan); to burn {See also 灼く やく} 6. to print (a photo); to burn (an optical disc) 7. to be jealous of; to be envious of; to envy {See also 妬く やく} | Other forms: 燬く 【やく】、焚く 【やく】 [Notes] 燬く: Out-dated kanji. 焚く: Out-dated kanji.
約束	やくそく	JLPT N4	[Noun, Suru verb] 1. promise; agreement; arrangement; one's word; contract; pact; appointment; engagement; date 2. convention; rule 3. destiny; fate
役に立つ	やくにたつ	JLPT N4	[Expression, Godan verb with tsu ending] 1. to be helpful; to be useful | Other forms: 役にたつ 【やくにたつ】、やくに立つ 【やくにたつ】
焼ける	やける	JLPT N4	[Ichidan verb, intransitive verb] 1. to burn; to be roasted; to be heated; to be sunburnt; to fade (in the sun); to glow red (i.e. of the sky at sunset) {Only applies to 焼ける} 2. to be jealous; to be envious | Other forms: 灼ける 【やける】、妬ける 【やける】
優しい	やさしい	JLPT N4	[I-adjective] 1. tender; kind; gentle; graceful; affectionate; amiable
痩せる	やせる	JLPT N4	[Ichidan verb, intransitive verb] 1. to become thin; to lose weight; to reduce (one's) weight; to slim 2. to be barren; to be infertile; to be sterile | Other forms: 痩る 【やせる】、瘠せる 【やせる】、瘠る 【やせる】、瘦せる 【やせる】 [Notes] 痩る: Irregular okurigana usage. 瘠る: Irregular okurigana usage. 瘦せる: Out-dated kanji.
やっと	やっと	JLPT N4	[Adverb] 1. at last; at length {Onomatopoeic or mimetic word} 2. barely; narrowly; just; by the skin of one's teeth {Onomatopoeic or mimetic word}
止む	やむ	JLPT N4	[Godan verb with mu ending, intransitive verb] 1. to cease; to stop; to be over | Other forms: 已む 【やむ】、罷む 【やむ】
止める	やめる	JLPT N4	[Ichidan verb, Transitive verb] 1. to stop (an activity); to cease; to discontinue; to end; to quit {Usually written using kana alone, Only applies to 止める, Only applies to 已める} 2. to cancel; to abandon; to give up; to abolish; to abstain; to refrain {Usually written using kana alone} | Other forms: 已める 【やめる】、廃める 【やめる】
柔らかい	やわらかい	JLPT N4	[I-adjective] 1. soft; tender; limp; limber 2. gentle; mild 3. informal; lighter | Other forms: 軟らかい 【やわらかい】、柔かい 【やわらかい】 [Notes] 柔かい: Irregular okurigana usage.
湯	ゆ	JLPT N4	[Noun] 1. hot water {See also 水 みず} 2. hot bath; hot spring 3. molten iron
指	ゆび	JLPT N4	[Noun] 1. finger; toe; digit | Other forms: 指 【および】、指 【おゆび】
指輪	ゆびわ	JLPT N4	[Noun] 1. (finger) ring | Other forms: 指環 【ゆびわ】
夢	ゆめ	JLPT N4	[Noun] 1. dream
揺れる	ゆれる	JLPT N4	[Ichidan verb, intransitive verb] 1. to shake; to sway; to waver
用	よう	JLPT N4	[Noun, Noun - used as a suffix] 1. task; business 2. use; duty; service 3. call of nature; excretion {See also 用を足す} [Place] 4. You
用意	ようい	JLPT N4	[Noun, Suru verb] 1. preparation; arrangements; provision; getting ready; laying out (e.g. a meal)
用事	ようじ	JLPT N4	[Noun] 1. tasks; things to do; errand; business (to take care of); affairs; engagement
汚れる	よごれる	JLPT N4	[Ichidan verb, intransitive verb] 1. to get dirty; to become dirty 2. to become sullied; to become corrupted; to lose one's chastity {See also 汚れる けがれる}
予習	よしゅう	JLPT N4	[Noun, Suru verb] 1. preparation for a lesson
予定	よてい	JLPT N4	[Noun, Suru verb] 1. plans; arrangement; schedule; program; programme; expectation; estimate
予約	よやく	JLPT N4	[Noun, Suru verb, No-adjective] 1. reservation; appointment; booking; advance order 2. contract; subscription; pledge [Noun, Suru verb] 3. programming (e.g. a device); setting (e.g. a timer)
寄る	よる	JLPT N4	[Godan verb with ru ending, intransitive verb] 1. to approach; to draw near; to come near; to be close to 2. to gather (in one place); to come together; to meet 3. to stop by (while on one's way to another place); to drop by; to make a short visit 4. to grow old; to grow high (number, etc.) {See also 年が寄る} 5. to grow (wrinkly) {in the form of しわが寄る} 6. to lean against; to recline on {also written as 倚る, 凭る} 7. to push one's opponent while holding their belt {Sumo term} 8. to decide on a price and come to a deal 9. to be swayed by (a person); to yield to {Archaism}
喜ぶ	よろこぶ	JLPT N4	[Godan verb with bu ending] 1. to be delighted; to be glad; to be pleased 2. to congratulate 3. to gratefully accept {See also 喜んで} | Other forms: 悦ぶ 【よろこぶ】、歓ぶ 【よろこぶ】、慶ぶ 【よろこぶ】、欣ぶ 【よろこぶ】
理由	りゆう	JLPT N4	[Noun] 1. reason; pretext; motive | Other forms: 理由 【わけ】 [Notes] わけ: Irregular kana usage.
利用	りよう	JLPT N4	[Noun, Suru verb] 1. use; utilization; utilisation; application
両方	りょうほう	JLPT N4	[Noun, No-adjective] 1. both; both sides; both parties {See also 片方}
旅館	りょかん	JLPT N4	[Noun] 1. ryokan; Japanese-style lodging, usu. professionally-run {See also 民宿 みんしゅく}
留守	るす	JLPT N4	[Noun, Suru verb] 1. absence; being away from home 2. house-sitting; house-sitter 3. being left unattended to (of one's studies, etc.); neglecting {usu. as お留守になる} | Other forms: 留主 【るす】
冷房	れいぼう	JLPT N4	[Noun, Suru verb] 1. cooling; air-conditioning {Antonym: 暖房}
歴史	れきし	JLPT N4	[Noun, No-adjective] 1. history
レジ	レジ	JLPT N4	[Noun] 1. (cash) register {Abbreviation, See also レジスター} 2. cashier {Abbreviation, See also レジ係} [Place] 3. Rezh (Russia); Reg [Notes] レジ: gai1.
レポート	レポート	JLPT N4	[Noun, Suru verb] 1. report; paper | Other forms: リポート [Notes] レポート: gai1, ichi1. リポート: gai1, ichi1.
連絡	れんらく	JLPT N4	[Suru verb, No-adjective] 1. to contact; to get in touch {See also ご連絡} [Noun] 2. contacting; getting in touch; communication; call; message {See also ご連絡} 3. connection; coordination; junction [No-adjective] 4. intercalary; intercalaris; internuncial | Other forms: 聯絡 【れんらく】
ワープロ	ワープロ	JLPT N4	[Noun] 1. word processor {Computer terminology, Abbreviation}
沸かす	わかす	JLPT N4	[Godan verb with su ending, Transitive verb] 1. to boil; to heat {Only applies to 沸かす} 2. to excite {Only applies to 沸かす} 3. to melt (metal) {Archaism} | Other forms: 鎔かす 【わかす】
別れる	わかれる	JLPT N4	[Ichidan verb, intransitive verb] 1. to be divided; to part from; to separate (usu. for people); to bid farewell
沸く	わく	JLPT N4	[Godan verb with ku ending, intransitive verb] 1. to grow hot (e.g. water); to boil 2. to be in a state of excitement; to get excited; to take place energetically; to erupt (e.g. in applause, cheers)
訳	わけ	JLPT N4	[Noun] 1. conclusion from reasoning, judgement or calculation based on something read or heard; reason; cause; meaning; circumstances; situation {Usually written using kana alone}
忘れ物	わすれもの	JLPT N4	[Noun] 1. lost article; something forgotten
笑う	わらう	JLPT N4	[Godan verb with u ending, intransitive verb] 1. to laugh 2. to smile 3. to sneer; to ridicule {esp. 嗤う} 4. to be dumbfounded; to be flabbergasted {as 笑ってしまう or 笑っちゃう} | Other forms: 咲う 【わらう】、嗤う 【わらう】
割合	わりあい	JLPT N4	[Adverb, Noun] 1. rate; ratio; percentage; proportion 2. comparatively 3. contrary to expectations | Other forms: 割り合い 【わりあい】 [Notes] 割り合い: Irregular okurigana usage.
割れる	われる	JLPT N4	[Ichidan verb, intransitive verb] 1. to break; to be smashed 2. to split; to crack; to fissure; to be torn 3. to be divided; to cleave 4. to come to light; to be identified; to be established; to become clear | Other forms: 破れる 【われる】