A: Prefectures of Japan
B: 北海道	Hokkaido
B: 東北	Tohoku
B: 青森	Aomori
B: 秋田	Akita
B: 岩手	Iwate
B: 山形	Yamagata
B: 宮城	Miyagi
B: 福島	Fukushima
B: 関東	Kanto
B: 栃木	Tochigi
B: 群馬	Gunma
B: 茨城	Ibaraki
B: 埼玉	Saitama
B: 東京	Tokyo
B: 千葉	Chiba
B: 神奈川	Kanagawa
B: 中部	Chubu
B: 新潟	Niigata
B: 石川	Ishikawa
B: 富山	Toyama
B: 長野	Nagano
B: 福井	Fukui
B: 岐阜	Gifu
B: 山梨	Yamanashi
B: 愛知	Aichi
B: 静岡	Shizuoka
B: 関西	Kansai
B: 兵庫	Hyogo
B: 京都	Kyoto
B: 滋賀	Shiga
B: 大阪	Osaka
B: 奈良	Nara
B: 三重	Mie
B: 和歌山	Wakayama
B: 中国	Chugoku
B: 鳥取	Tottori
B: 島根	Shimane
B: 岡山	Okayama
B: 広島	Hiroshima
B: 山口	Yamaguchi
B: 四国	Shikoku
B: 香川	Kagawa
B: 愛媛	Ehime
B: 徳島	Tokushima
B: 九州	Kyushu
B: 沖縄	Okinawa
B: 福岡	Fukuoka
B: 佐賀	Saga
B: 長崎	Nagasaki
B: 熊本	Kumamoto
B: 大分	Oita
B: 宮崎	Miyazaki
B: 鹿児島	Kagoshima
B: 沖縄	Okinawa
C: Largest prefecture - Hokkaido
C: Smallest prefecture - Kagawa
C: Prefectures with both Pacific and Japan Sea coasts - Aomori & Hyogo
C: Prefecture with the highest population density - Tokyo
C: Prefecture with the most islands - Nagasaki
C: Prefecture with the most dogs - Aichi
C: Prefecture with the largest rice yield - Niigata
C: Prefecture with the most cows - Hokkaido
C: Prefecture with the smallest population - Tottori
C: Poorest prefecture - Okinawa