(よんじゅうに)	四十二	"forty two, the answer"	2
(かいがん)	海岸	"seashore, coast, seacoast"	11
(くろい)	黒い	"black"	7
(ちち)	父	"father"	3
(かたな)	刀	"sword, katana"	2
(すうじ)	数字	"numeral, digit"	8
(かく, かど)	角	"angle, corner"	5
(さんかく)	三角	"triangle"	5
(でぐち)	出口	"exit"	2
(らいげつ)	来月	"next month"	5
(たいない)	体内	"internal, within the body, inside the body"	5
(じんこう)	人口	"population"	1
(こ)	子	"kid, child"	2
(しんがん)	心願	"heartfelt desire, heartfelt wish, prayer, heart's desire"	13
(ねがいごと)	願い事	"one's wish, prayer, wish"	17
(むし)	虫	"bug, insect"	4
(ねっしん)	熱心	"enthusiasm, passion, zeal"	13
(あつい)	熱い	"hot thing, hot"	13
(えきちょう)	駅長	"station master, stationmaster, train station master, train stationmaster"	13
(どうかん)	同感	"sympathy, same sentiment, concurrence, agree, empathy"	13
(ごかん)	五感	"the five senses, five senses"	13
(かんしゃ)	感謝	"thanks, gratitude"	13
(ゆびわ)	指輪	"ring"	15
(しゃりん)	車輪	"tire, car wheel, tyre"	13
(えいがかん)	映画館	"movie theater, cinema, movie theatre"	15
(えいが)	映画	"movie, film"	13
(みみうち)	耳打ち	"whisper in ear, whisper in one's ear, whisper in someone's ear"	4
(なさけ)	情け	"pity, sympathy, mercy, compassion"	13
(にんじょう)	人情	"humanity, human feelings, empathy, kindness, sympathy"	13
(しんじゅく)	新宿	"shinjuku"	13
(ひょうじょう)	表情	"facial expression"	13
(わ)	輪	"ring, wheel, loop"	13
(みる)	見る	"to see, to look"	4
(えき)	駅	"station, train station"	13
(えきまえ)	駅前	"front of station, in front of station, front of the station, in front of the station, station front"	13
(ふゆやすみ)	冬休み	"winter holiday, winter break, winter vacation"	6
(かんじ)	感じ	"feeling, sense, impression"	13
(かちょう)	課長	"section manager, section chief"	13
(やくぶつ)	薬物	"medicines, drugs"	17
(くすり)	薬	"medicine, drug, drugs"	17
(やくほう)	薬方	"prescription"	17
(やくがく)	薬学	"study of pharmacy, pharmacology, pharmaceutics"	17
(そうだん)	相談	"consultation, discussion, advice"	9
(じゅうろく)	十六	"sixteen"	2
(た)	田	"rice field, rice paddy"	2
(むっつ)	六つ	"six things"	2
(かいし)	開始	"start, beginning, opening"	10
(き)	木	"tree, wood"	2
(まるごと)	丸ごと	"in its entirety, whole, wholly, entirely"	4
(しんちく)	新築	"newly built, new building, new construction"	15
(にせんじゅういちねん)	２０１１年	"year 2011, 2011, the year 2011"	4
(きねんび)	記念日	"holiday, anniversary, memorial day"	16
(えきいん)	駅員	"train station employee, train station staff, train station attendant, station attendant, station employee"	13
(おとうと)	弟	"younger brother, little brother"	5
(きよう)	器用	"dextrous, skillful, dexterous, skilful"	13
(ぶきよう)	不器用	"clumsy, unskillful"	15
(はいる)	入る	"to enter"	1
(じ)	字	"character, kanji character, letter, symbol"	4
(きゅうし)	休止	"pause, rest, break"	4
(せいり)	整理	"arrangement, sorting, organization, adjustment"	13
(れんしゅう)	練習	"practice"	13
(せいりする)	整理する	"to arrange, to organize, to sort"	15
(せいぜん)	整然	"orderly, systematic, well organized, natural order"	13
(あやまる)	謝る	"to apologize, to apologise"	13
(ふくしま)	福島	"fukushima"	13
(うつわ)	器	"container, bowl, vessel"	13
(なげつける)	投げ付ける	"to throw against, to throw at"	10
(おく)	億	"hundred million"	13
(いちおく)	一億	"one hundred million"	13
(かんじょう)	感情	"feeling, emotion"	13
(じっかん)	実感	"real feeling, actual feeling"	13
(いちおくえん)	一億円	"one hundred million yen"	13
(おちば)	落ち葉	"fallen leaves, fallen leaf"	12
(せんろ)	線路	"railroad track, train track, railway track, track, line"	10
(わごむ, わゴム)	輪ゴム	"rubber band, elastic band"	15
(どうろ)	道路	"paved road, road, sealed road"	10
(はつか)	二十日	"twentieth day, day twenty, twenty days"	4
(なのか)	七日	"seventh day, day seven, seven days"	2
(とおり)	通り	"avenue, street, road, way"	9
(きほん)	基本	"foundation, basics"	14
(かんぜん)	完全	"complete, perfect, perfection, completeness"	14
(しつぼう)	失望	"disappointment, despair"	14
(しせいかつ)	私生活	"personal life, one's personal life, private life, one's private life"	14
(わたし, わたくし)	私	"i"	14
(しだい)	私大	"private college, private university, private uni"	18
(じんせい)	人性	"human nature, instinct"	14
(せいびょう)	性病	"sexually transmitted disease, std, sexually transmitted infection, sti"	14
(だんせい)	男性	"male, man, guy"	14
(せい)	性	"gender, nature, sex"	14
(かためる)	固める	"to make hard, to harden"	16
(かたい)	固い	"hard"	14
(かたまる)	固まる	"to harden, to solidify, to become firm, to become certain"	18
(みっか)	三日	"third day, day three, three days"	2
(ざんねん)	残念	"too bad, unfortunate"	14
(もくてき)	目的	"purpose, goal, motive"	14
(よわむし)	弱虫	"weakling, coward"	9
(きぼうする)	希望する	"to request, to wish, to hope, to want, to expect"	16
(おる)	折る	"to fold"	14
(おりめ)	折り目	"fold, crease"	16
(せっかく)	折角	"with trouble, with difficulty, going through the trouble, trouble with, difficulty with, on purpose, deliberately"	14
(だきょうする)	妥協する	"to compromise"	16
(きょうかい)	協会	"union, association, organization, organisation"	14
(だきょう)	妥協	"compromise, giving in"	14
(しゅうき)	周期	"cycle, period"	14
(ごうかくする)	合格する	"to pass a test, to pass an exam"	14
(ざいりょう)	材料	"ingredients, material"	14
(そつぎょうする)	卒業する	"to graduate"	16
(ほんのう)	本能	"instinct"	14
(れいぶん)	例文	"example sentence, model sentence, sample sentence"	14
(あくれい)	悪例	"bad example, bad precedent"	14
(げいのうかい)	芸能界	"showbusiness, showbiz, show business"	14
(げいしゃ)	芸者	"geisha"	14
(げいにん)	芸人	"comedian, actor, performer"	14
(りせい)	理性	"reason, sense, intellect, understanding"	14
(さんにん)	三人	"three people, three persons"	1
(のこす)	残す	"to leave behind, to leave over"	16
(ふかんぜん)	不完全	"incomplete, imperfect"	16
(はな)	花	"flower"	4
(よう)	用	"task, use, duty, service, business, purpose, function"	3
(べいこく)	米国	"america, united states, united states of america, usa"	6
(まいにち)	毎日	"every day, daily"	5
(ようきゅう)	要求	"demand, requirement"	14
(せいかく)	性格	"personality, character"	14
(こっかく)	骨格	"skeleton"	14
(こっせつ)	骨折	"broken bone, fracture, bone fracture"	14
(ここのか)	九日	"nine days, day nine, ninth day"	2
(ととのえる)	整える	"to arrange, to put in order, to adjust, to prepare"	15
(してつ)	私鉄	"private railway"	14
(かっこう)	格好	"shape, form, posture, appearance"	14
(がんぼう)	願望	"desire, wish, aspiration"	14
(たとえば)	例えば	"for example, for instance"	14
(きょうりょく)	協力	"cooperation"	14
(わたしじしん, わたくしじしん)	私自身	"personally, as for me, myself"	16
(あし)	足	"foot, leg"	4
(たりない)	足りない	"not enough, to not be sufficient, to not be enough, insufficient, not sufficient, to be insufficient"	6
(のぞみ)	望み	"wish, hope, desire"	14
(しゃない)	車内	"inside the car, in the car, in a car, inside a car, within the car, within a car"	4
(かわ)	皮	"skin, hide"	4
(げんき)	元気	"energy, spirit, health"	4
(しかたがない)	仕方がない	"can't be helped, it can't be helped, no use, it's no use, it is no use"	6
(しゅうねん)	周年	"anniversary"	14
(いちれい)	一例	"instance, example"	14
(しき)	四季	"the four seasons, four seasons"	14
(かわり)	代わり	"substitute, replacement"	6
(とおか)	十日	"ten days, day ten, tenth day"	2
(じんかく)	人格	"character, personality"	14
(おねがい)	お願い	"a request, request, wish, please"	15
(さい)	〜才	"years old, age"	2
(がくねん)	学年	"school grade, grade in school, school year, year in school"	5
(まつ)	松	"pine, pine tree"	14
(まつば)	松葉	"pine needle"	14
(かこむ)	囲む	"to surround"	14
(ふんいき)	雰囲気	"atmosphere, ambience, ambiance, mood"	14
(しゅうい)	周囲	"perimeter, circumference, surroundings, environs"	14
(きほんてき)	基本的	"fundamentals, basics, fundamental, standard, basic"	16
(じどうてき)	自動的	"automatic"	16
(にほんてき)	日本的	"very japanese, typically japanese"	14
(きんだいてき)	近代的	"modern"	14
(やくそく)	約束	"promise, appointment, pact"	14
(よやく)	予約	"reservation, appointment"	14
(ある)	有る	"to have, to exist"	6
(げいじゅつか)	芸術家	"artist"	16
(びじゅつかん)	美術館	"museum, art museum, art gallery"	16
(げいじゅつ)	芸術	"art, the arts, fine art"	14
(ひとびと)	人々	"people, everybody"	2
(ざいもく)	材木	"lumber, timber, wood"	14
(かず)	数	"number, count, amount"	8
(すうねん)	数年	"several years"	8
(れいがい)	例外	"exception"	14
(ようび)	曜日	"day of the week, weekday"	16
(がんこ)	頑固	"stubborn"	14
(かんりょう)	完了	"completion, complete, finish, conclusion"	14
(しょっき)	食器	"tableware, eating utensils, utensils"	13
(まわり)	周り	"circumference, perimeter, edge, surroundings, locality, neighborhood"	14
(あおば)	青葉	"fresh leaves, greenery, young leaves"	10
(さいのう)	才能	"talent, ability, genius"	14
(どようび)	土曜日	"saturday"	18
(げつようび)	月曜日	"monday"	18
(かんじる)	感じる	"to feel"	13
(えん)	円	"money, yen"	2
(しゃしん)	写真	"photo, photograph, picture"	16
(まっくろ)	真っ黒	"pitch black, pure black"	16
(まるい)	丸い	"circular, round, spherical"	2
(ふごうかく)	不合格	"fail a test, failure, fail an exam"	16
(なおす)	治す	"to cure, to heal"	16
(せいじ)	政治	"politics, government"	16
(ふじ, ふち )	不治	"incurability, incurable"	16
(ろく)	六	"six"	2
(しる)	知る	"to know"	6
(かえる)	代える	"to replace, to substitute, to exchange, to replace something, to substitute something, to exchange something"	6
(やど)	宿	"lodging, inn, hotel, lodge"	13
(にもつ)	荷物	"luggage, baggage, load"	16
(てにもつ)	手荷物	"hand baggage, hand luggage, cabin baggage, carry on"	18
(しんじん)	信心	"faith, belief"	15
(しんごう)	信号	"traffic light, signal, traffic signal, stoplight, semaphore"	15
(ふしん)	不信	"distrust, unfaithfulness"	15
(えいぶん)	英文	"english writing, english composition"	15
(えいかいわ)	英会話	"english conversation"	15
(えいご)	英語	"english language, english"	15
(えいこく)	英国	"britain, uk, united kingdom, england"	15
(ごはん)	ご飯	"meal, cooked rice"	15
(あさごはん)	朝ご飯	"breakfast"	17
(ばんごはん)	晩ご飯	"dinner, supper"	17
(うつる)	映る	"to be reflected, to be projected"	13
(そつぎょうしき)	卒業式	"graduation ceremony, graduation"	16
(しき)	式	"ceremony, ritual, equation"	15
(なさけない)	情けない	"miserable, pitiable, shameful, deplorable, wretched, sad, pitiful"	15
(おもいだす)	思い出す	"to remember, to recall"	8
(じょうし)	上司	"boss, superior"	15
(ぶつぞう)	仏像	"image of buddha, statue of buddha"	16
(だいぶつ)	大仏	"giant buddha statue, daibutsu, giant statue of buddha, large buddha statue, large statue of buddha"	15
(ぶっきょう)	仏教	"buddhism"	15
(いとてき)	意図的	"intentional, on purpose"	14
(かわる)	変わる	"to be changed, to be transformed, to be altered, to vary, to be turned"	17
(へん)	変	"strange"	15
(ぐんじん)	軍人	"soldier"	15
(どくがす, どくガス)	毒ガス	"poison gas"	15
(ゆうどく)	有毒	"poisonous, toxic"	15
(しょくちゅうどく)	食中毒	"food poisoning"	15
(てき)	〜的	"al, like, typical"	14
(く)	区	"district, ward"	15
(じょうだん)	冗談	"joke"	16
(けんちく)	建築	"architecture, construction"	15
(おおさか)	大阪	"osaka, oosaka"	16
(はんしん)	阪神	"hanshin"	16
(べんとう)	弁当	"bento, box lunch"	16
(べん)	〜弁	"dialect"	16
(えきべん)	駅弁	"train station bento, station bento"	18
(おおさかべん)	大阪弁	"osaka dialect"	18
(かんさい)	関西	"kansai"	16
(かんけい)	関係	"connection, relation"	16
(かんさいべん)	関西弁	"kansai dialect"	18
(おまもり)	お守り	"charm, amulet"	18
(いっしゅう)	一周	"one time around, once around"	14
(あぶない)	危ない	"dangerous"	16
(ぐん)	軍	"army, troops, force"	15
(へんじん)	変人	"an eccentric, eccentric, oddball"	15
(やくする)	約する	"to promise"	14
(なく)	泣く	"to cry"	15
(せいき)	世紀	"century"	15
(たんに)	単に	"simply, merely"	15
(どく)	毒	"poison"	15
(たつ)	建つ	"to be erected, to be built"	17
(ちく)	地区	"district, area, zone"	15
(さっこん)	昨今	"these days, nowadays"	15
(おととい, いっさくじつ)	一昨日	"day before last, day before yesterday"	17
(はれる)	晴れる	"to clear up, to become sunny"	15
(ちゅうどく)	中毒	"poisoning, addiction"	15
(めし)	飯	"meal, cooked rice, food"	15
(きゅうじつ)	休日	"holiday"	4
(たんご)	単語	"word, vocabulary"	15
(いちねんせい)	一年生	"first year student"	4
(ぶってん)	仏典	"buddhist scriptures, buddhist writing"	16
(せいほ)	生保	"life insurance"	16
(ほぞん)	保存	"preserve, preservation, conservation"	16
(ほじする)	保持する	"to maintain, to preserve"	18
(ごみばこ, ゴミばこ)	ゴミ箱	"garbage can, garbage bin, trash can, trash bin, waste can, waste bin, rubbish bin"	16
(きゅう)	急	"urgent, sudden, abrupt"	16
(きゅうに)	急に	"suddenly, immediately, abruptly"	16
(きゅうし)	急死	"sudden death"	16
(くぶん)	区分	"division, classification"	15
(かいぐん)	海軍	"navy"	15
(たいら)	平ら	"flat"	4
(きのう, さくじつ)	昨日	"yesterday"	15
(はる)	春	"spring"	15
(はるやすみ)	春休み	"spring break, spring vacation, spring holiday"	15
(かんそう)	感想	"impressions, one's impressions, thoughts"	13
(ごうけい)	合計	"total, sum"	15
(けいさん)	計算	"calculation"	15
(いわ)	岩	"boulder"	15
(あき)	秋	"autumn, fall"	15
(ひる)	昼	"noon"	15
(ひるやすみ)	昼休み	"lunch break, noon break"	15
(ひるごはん)	昼ご飯	"lunch"	17
(かいわ)	会話	"conversation, dialogue"	8
(こねこ)	子猫	"kitten, kitty"	15
(くに)	国	"country, nation"	6
(たてる)	建てる	"to build, to construct"	15
(ほんとう)	本当	"reality, truth"	5
(てんさい)	天才	"genius"	2
(ごじゅう)	五十	"fifty"	2
(ふつか)	二日	"second day, day two, two days"	2
(め)	目	"eye"	2
(よんじゅう)	四十	"forty"	2
(つき)	月	"moon, month"	2
(て)	手	"hand"	2
(みぎ)	右	"right direction, right"	2
(てら)	寺	"temple"	15
(ねこ)	猫	"cat"	15
(とけい)	時計	"watch, clock"	15
(かえる)	帰る	"to return home, to return"	15
(はれ)	晴れ	"clear weather"	15
(どせい)	土星	"saturn"	6
(かえる)	変える	"to change"	15
(いっぽ)	一歩	"one step"	6
(ちゅうごく)	中国	"china"	6
(にほん, にっぽん)	日本	"japan"	2
(おうじょ)	王女	"princess"	2
(じょおう)	女王	"queen"	2
(おうじ)	王子	"prince"	2
(あさい)	浅い	"shallow"	15
(へんしん)	返信	"reply"	15
(ひだりて)	左手	"left hand"	2
(じょし)	女子	"girl"	2
(ぎじゅつ)	技術	"art, craft, technique"	16
(たけ, だけ)	丈	"height, only, just"	15
(こざら)	小皿	"small plate, small dish, little plate, little dish"	4
(かん)	〜間	"amount of time, interval of time, time interval, period of time"	8
(じかん)	時間	"time"	8
(おれる)	折れる	"to break, to snap, to fracture"	16
(おりがみ)	折り紙	"origami, art of paper folding"	16
(おもいで)	思い出	"a memory, memories, memory"	8
(ばん)	晩	"night, evening"	15
(れんしゅうする)	練習する	"to practice, to practise"	15
(やく)	約	"about, approximately"	14
(てんすう)	点数	"points, score"	8
(かんがえかた)	考え方	"way of thinking, thought process"	5
(がくもん)	学問	"scholarship, study, learning"	13
(あんきする)	暗記する	"to memorize, to memorise"	15
(くらい)	暗い	"dark"	13
(ぶんぽう)	文法	"grammar"	15
(さまざま)	様々	"various, many"	13
(さま)	〜様	"formal name ender, formal name title, sama, very formal name ender"	13
(せんしゅ)	選手	"pro athlete, sports player, professional athlete"	13
(えらぶ)	選ぶ	"to choose"	13
(みどりいろ)	緑色	"green, color green, green color, colour green, green colour"	13
(みどり)	緑	"green"	13
(りょかん)	旅館	"japanese inn, japanese hotel, inn, ryokan, japanese style inn, japanese style hotel"	13
(ぜんにほん, ぜんにっぽん)	全日本	"all japan, all of japan"	6
(がっき)	楽器	"musical instrument"	13
(りきし)	力士	"sumo wrestler"	13
(ようし)	養子	"adopted child"	13
(みなさん, みんなさん)	皆さん	"everyone, everybody, all"	13
(みなさま)	皆様	"everyone, all, everybody"	13
(のみかい)	飲み会	"drinking party"	13
(とおる)	通る	"to pass, to pass through"	7
(えいわ)	英和	"english japanese"	15
(おねがいします)	お願いします	"please help me, please, if you would be so kind"	13
(ふりょう)	不良	"bad, substandard, delinquent"	11
(かわる)	代わる	"to replace, to substitute for, to substitute, to be replaced, to be substituted, to be substituted for"	4
(つきみ)	月見	"moon viewing"	4
(おちる)	落ちる	"to fall down, to drop, to fall"	10
(つき)	〜付き	"including, included, furnished with, attached to"	11
(ふきん)	付近	"neighborhood, neighbourhood, vicinity, environs, nearby, locality"	9
(てがみ)	手紙	"letter"	7
(ほか)	他	"other"	4
(しかた)	仕方	"method, way, way of doing"	4
(ご)	五	"five"	2
(よっつ)	四つ	"four things"	2
(ようか)	八日	"eight days, day eight, eighth day"	2
(せんえん)	千円	"1000 yen, one thousand yen, a thousand yen, thousand yen"	2
(ほん)	本	"book"	2
(なか)	仲	"relationship, relation"	11
(せん)	千	"thousand"	2
(こうつう)	交通	"traffic"	7
(ちいさい)	小さい	"small, little"	2
(たま)	玉	"ball"	2
(いぬ)	犬	"dog"	2
(かしゅ)	歌手	"singer"	10
(おれい)	お礼	"thanks, gratitude"	4
(たしざん)	足し算	"addition"	10
(まるい)	円い	"round, circular"	2
(ぶしゅ)	部首	"radical"	9
(ふめい)	不明	"unknown, unclear, uncertain, unsure"	6
(たりる)	足りる	"to be enough, to be sufficient, to suffice"	4
(たてる)	立てる	"to stand up, to stand something up, to erect, to erect something"	2
(むら)	村	"village, rural town"	4
(つける)	付ける	"to attach"	7
(きいろ)	黄色	"yellow, yellow colour, yellow color, colour yellow, color yellow"	7
(ただす)	正す	"to correct"	2
(もじどおり)	文字通り	"literal, literally, to the letter"	11
(くばる)	配る	"to distribute, to pass out, to deliver"	10
(みごと)	見事	"splendid, magnificent, beautiful, admirable, praiseworthy act, feat"	11
(しんぱいごと)	心配事	"cares, worries, troubles"	12
(みず)	水	"water"	2
(いっき)	一気	"one breath, one go, one sitting"	4
(すいちゅう)	水中	"underwater"	2
(めがみ)	女神	"goddess, female deity"	13
(まいげつ, まいつき)	毎月	"every month, monthly"	5
(まいかい)	毎回	"every time, each time"	5
(まいとし, まいねん)	毎年	"every year, yearly, annually, each year"	5
(ゆうべ)	夕べ	"evening, last night"	2
(ひろう)	拾う	"to pick up, to find, to gather"	11
(ちゅうもん)	注文	"order, request"	11
(しか, しいか)	詩歌	"poetry"	13
(しじん)	詩人	"poet"	13
(し)	詩	"poem"	13
(がぞう)	画像	"image, portrait, picture"	13
(さんていする)	算定する	"to calculate"	10
(くさち)	草地	"meadow, grassland"	6
(よん, し)	四	"four"	2
(おんなのこ)	女の子	"young lady, young woman, young girl, girl"	2
(こうがくしゃ)	工学者	"engineer"	8
(たすける)	助ける	"to help, to save, to rescue"	8
(くうかん)	空間	"space"	8
(がくしゃ)	学者	"scholar"	8
(じょりょく)	助力	"assistance, support"	8
(え)	絵	"painting, drawing, picture"	8
(うた)	歌	"song"	10
(さんすう)	算数	"arithmetic, math, mathematics"	10
(ようしつ)	洋室	"western style room"	11
(きって)	切手	"postage stamp, stamp"	4
(きる)	切る	"to cut"	3
(おにいさん)	お兄さん	"older brother, big brother, elder brother"	3
(しがつ)	四月	"april"	2
(わける)	分ける	"to separate, to divide, to part, to split"	3
(とめる)	止める	"to stop something, to stop"	3
(じゅうだい)	十台	"ten machines"	3
(にだい)	二台	"two machines"	3
(だい)	〜台	"big machine, big device, machine, device, machine counter, number of machines"	3
(いちだい)	一台	"one machine"	3
(あめ)	雨	"rain"	5
(かぞえる)	数える	"to count"	8
(にく)	肉	"meat"	5
(ひにく)	皮肉	"irony, sarcasm"	5
(ふとる)	太る	"to get fat, to become fat, to grow fat"	3
(また)	又	"again, and"	2
(ち)	地	"earth, ground"	6
(しかく)	四角	"square, rectangle"	5
(たにん)	他人	"another person, other people, stranger"	4
(すうがく)	数学	"mathematics, math, maths"	8
(まん)	万	"ten thousand"	3
(きれる)	切れる	"to be cut, to snap, to break"	3
(してん)	支店	"branch office, branch store"	8
(ぎもん)	疑問	"doubt"	13
(あんさつ)	暗殺	"assassination"	13
(ころす)	殺す	"to kill"	13
(さつじん)	殺人	"murder"	13
(いちだい)	一代	"lifetime, one lifetime, generation"	4
(もくひょう)	目標	"goal, target"	13
(しょうきん)	賞金	"cash prize, prize money"	13
(ぎゅうにく)	牛肉	"beef"	5
(ささえる)	支える	"to support"	8
(よむ)	読む	"to read"	10
(おなじ)	同じ	"same"	5
(ひく)	引く	"to pull, to subtract"	3
(はね)	羽	"feathers, feather, wing, wings"	5
(きゅうこう)	急行	"express"	16
(むりょく)	無力	"powerless, powerlessness, helplessness"	17
(むきゅう)	無休	"no holidays, always open"	17
(むち)	無知	"ignorance"	17
(むりょう)	無料	"free, without charge"	17
(なし)	無し	"without, with no"	17
(れつ)	列	"line, line of things, line of people, queue"	15
(ほとけ)	仏	"buddha"	15
(あいこくしん)	愛国心	"patriotism"	17
(じあい)	自愛	"self love, selfishness"	17
(あいする)	愛する	"to love"	17
(みぎがわ)	右側	"right side"	17
(とぐち)	戸口	"doorway"	3
(ふにんき)	不人気	"unpopular, not popular"	7
(しつ)	〜室	"room"	6
(うちがわ)	内側	"inside"	17
(りょうがわ)	両側	"both sides"	17
(ちゅうがくせい)	中学生	"middle school student, junior high school student, middle schooler, junior high schooler, junior high student"	7
(さっち)	察知	"inference, infer, sense"	17
(ちず)	地図	"map"	6
(さんかくけい, さんかっけい)	三角形	"triangle"	7
(こんしゅう)	今週	"this week"	7
(さかな)	魚	"fish"	7
(よみかた)	読み方	"reading, pronunciation, way of reading"	10
(きょうりょく)	強力	"strength, strong, powerful"	7
(じゅうしょ)	住所	"address"	8
(たけ)	竹	"bamboo"	4
(しそう)	思想	"thought, idea"	13
(こおり)	氷	"ice"	4
(あかちゃん)	赤ちゃん	"baby"	4
(たつ)	立つ	"to stand"	2
(にまん)	二万	"twenty thousand"	3
(だいよう)	代用	"substitution"	4
(うつす)	写す	"to copy, to photograph, to take a picture"	4
(こもじ)	小文字	"lowercase letter, lowercase character, lowercase, lowercase letters, lowercase characters"	6
(こうじょう, こうば)	工場	"factory"	8
(えもじ)	絵文字	"emoji"	8
(まったく)	全く	"completely, entirely, truly, really, wholly"	8
(しんこう)	進行	"advance, progress"	10
(すいぎん)	水銀	"mercury, quicksilver"	13
(ぎんいろ)	銀色	"silver, silver color, silver colour, colour silver, color silver"	13
(きんじつ)	近日	"soon, in a few days, coming days"	5
(ばしょ)	場所	"place, location, spot"	8
(よそう)	予想	"expectation, anticipation, expect, anticipate, prediction"	13
(しんたい, からだ)	身体	"the body, health, body"	8
(しんしん)	心身	"body and mind, mind and body"	8
(しきょく)	支局	"branch office"	8
(じりつ)	自立	"independence, self reliance"	5
(でんわ)	電話	"telephone, phone"	8
(やくにん)	役人	"public official, government official, public servant"	8
(やくめ)	役目	"duty, business, role"	8
(にっき)	日記	"diary, journal"	7
(ばあい)	場合	"case, circumstance, situation"	8
(あう)	合う	"to suit, to come together, to meet, to match"	8
(やくば)	役場	"town hall, town office, public office"	8
(きもちいい)	気持ちいい	"good feeling, feeling good, feels good"	11
(まもなく)	間もなく	"soon, before long, in a short time, shortly, momentarily"	8
(ちちゅうかい)	地中海	"mediterranean sea"	8
(あいず)	合図	"sign, signal"	8
(めいしゃ)	目医者	"eye doctor, oculist"	10
(かう)	買う	"to buy"	8
(じけつ)	自決	"suicide, self determination"	8
(よわよわしい)	弱々しい	"weak looking, frail, weak seeming, seemingly weak"	9
(きまる)	決まる	"to be decided, to be settled"	10
(たすかる)	助かる	"to be helped, to be saved, to be rescued"	10
(けんきゅうしつ)	研究室	"laboratory, lab, study room, professor's office, teacher's office"	10
(かいそう)	回想	"retrospection, reminiscence"	13
(じさつ)	自殺	"suicide"	13
(おうさま)	王様	"king"	13
(ばんごう)	番号	"number, series of digits"	8
(とうぜん)	当然	"natural, obvious"	13
(いちばん)	一番	"number one, the first, first, the best, best, the most, most"	8
(つく)	付く	"to be attached"	9
(けんきゅう)	研究	"investigation, study, research"	8
(ばんぐみ)	番組	"program, programme"	8
(ぎん)	銀	"silver"	13
(くも)	雲	"cloud"	8
(ただしい)	正しい	"correct, true"	2
(あに)	兄	"older brother, big brother, elder brother"	3
(がいじん)	外人	"foreigner, outsider"	3
(ふるい)	古い	"old"	3
(もじ)	文字	"letter (of the alphabet), character, letters, characters, letter"	4
(こたえ)	答え	"answer, reply, response"	8
(はん)	半	"half"	3
(いしゃ)	医者	"doctor"	8
(やく)	役	"role, part, duty, service"	8
(みつける)	見付ける	"to find, to find something"	9
(きゅうめい)	究明	"investigation"	8
(かた, ほう)	方	"way, direction"	3
(や)	矢	"arrow"	3
(と)	戸	"japanese style door, door"	3
(いますぐ)	今すぐ	"at once, right now, immediately, right away"	5
(おくじょう)	屋上	"rooftop, housetop"	11
(や)	〜屋	"store, shop"	9
(さかなや)	魚屋	"fish shop, fish market, fish dealer, fish store, fishmonger"	9
(なごや)	名古屋	"nagoya"	9
(にくや)	肉屋	"butcher shop, meat shop, meat store"	9
(びじん)	美人	"beautiful woman"	9
(うつくしい)	美しい	"beautiful"	9
(およぎ)	泳ぎ	"swimming, swim"	9
(はずれ)	外れ	"extremity, furthest point, end, outskirts, outer limits, edge, miss, failure"	3
(し)	市	"city"	3
(しりつ)	市立	"municipal, city"	3
(ひさしい)	久しい	"long time"	3
(ふく)	服	"clothes, clothing"	9
(ちゃや)	茶屋	"tea shop, tea store, tea house"	9
(けっしん)	決心	"determination, resolution, conviction"	8
(かつよう)	活用	"conjugation, practical use"	6
(くるしい)	苦しい	"painful, agonizing, agonising"	9
(たいだん)	対談	"conversation, dialogue, talk"	9
(さくしゃ)	作者	"author, writer"	8
(うりきれ)	売り切れ	"sold out, out of stock"	5
(ごご)	午後	"pm, afternoon"	6
(ぜんべい)	全米	"all america"	8
(ほんや)	本屋	"bookstore, book shop"	9
(どうじつ)	同日	"same day, the same day"	5
(にんき)	人気	"popular, popularity"	4
(ゆき, いき)	行き	"train direction, bound for"	5
(あした, あす, みょうにち)	明日	"tomorrow"	8
(こうよう)	公用	"government business, official business"	3
(いだい)	医大	"medical university, medical school, med school"	8
(やしなう)	養う	"to foster, to raise, to rear"	13
(まげる)	曲げる	"to bend, to bend something"	8
(じんじゃ)	神社	"shinto shrine"	11
(かみかぜ)	神風	"kamikaze, divine winds"	13
(ほうだい)	〜放題	"as much as you want, all you can"	13
(もんだい)	問題	"problem, question"	13
(のみほうだい)	飲み放題	"all you can drink"	15
(たべほうだい)	食べ放題	"all you can eat"	15
(ほんき)	本気	"serious"	4
(ぎんこう)	銀行	"bank"	13
(ぜんぜん)	全然	"entirely, completely, not at all"	13
(わだい)	話題	"topic, subject"	13
(ろうどう)	労働	"manual labor, manual labour, labor, labour"	11
(へいわ)	平和	"peace, harmony"	9
(はなす)	話す	"to speak, to talk"	8
(のせる)	乗せる	"to give a ride, to give someone a ride, to place on"	9
(おう)	追う	"to chase, to follow"	11
(きょうゆう)	共有	"shared, co ownership, joint ownership, share"	11
(きょうゆうする)	共有する	"to share, to own jointly, to co own"	13
(せんげつ)	先月	"last month, previous month"	4
(めいしょ)	名所	"famous place"	8
(わふう)	和風	"japanese style"	9
(まちあいしつ)	待合室	"waiting room"	13
(まけいぬ)	負け犬	"loser"	11
(まける)	負ける	"to lose, to be defeated"	9
(せいぶつがく)	生物学	"biology"	11
(もの)	物	"thing"	9
(どうぐ)	道具	"tool"	9
(ちかぢか, きんきん, ちかじか)	近々	"before long, soon"	7
(ちかづく)	近づく	"to get close, to approach, to draw near, to near, to bring near"	8
(しゃかい)	社会	"society"	7
(おくる)	送る	"to send"	9
(まつ)	待つ	"to wait"	9
(めいぶつ)	名物	"local specialty, famous product, specialty, famous goods"	9
(きゃくしつ)	客室	"guest room"	9
(けんぶつ)	見物	"sightseeing, sightseer, watching, watcher, viewing, viewer"	9
(ほんもの)	本物	"the real thing, real deal, the real deal, real thing, genuine article, the genuine article"	9
(たいかい)	大会	"convention, tournament, meetup, event"	5
(ハートがた, はーとがた)	ハート形	"heart shaped"	9
(あおぞら)	青空	"blue sky"	7
(またせる)	待たせる	"to make someone wait, to keep someone waiting, to make wait, to keep waiting"	9
(まちあい)	待合	"waiting room, meeting place"	11
(ちゅうきゅう)	中級	"intermediate level, intermediate rank, intermediate grade"	11
(なに, なん)	何	"what"	5
(せいねん)	青年	"youth, young man"	5
(はしる)	走る	"to run"	5
(じょうきゅう)	上級	"advanced level, high grade, advanced grade, high level"	11
(にっこう)	日光	"sunlight"	5
(こうねん)	光年	"light year"	5
(うむ)	生む	"to give birth, to produce"	3
(なみ)	波	"wave"	11
(へた)	下手	"unskillful, unskilled, bad at, not good at, not skilled"	2
(いつか)	五日	"fifth day, day five, five days"	2
(たまねぎ)	玉ねぎ	"onion, round onion"	2
(しつれい)	失礼	"rude, rudeness, impoliteness"	7
(しかえし)	仕返し	"get even, retaliation, get back at, revenge, get revenge"	11
(みかえす)	見返す	"to look back at, to triumph over"	15
(みかえる)	見返る	"to look back at, to look back on"	13
(みかた)	見方	"way of seeing, point of view, perspective, viewpoint"	4
(みわける)	見分ける	"to distinguish, to tell apart, to differentiate"	4
(みせる)	見せる	"to show"	4
(ぜんぶ)	全部	"all, entire, whole"	9
(けん)	〜県	"prefecture"	9
(ぶぶん)	部分	"portion, section, part"	9
(たけのこ)	竹の子	"bamboo shoots, bamboo sprouts"	4
(へや)	部屋	"room"	9
(うまれる)	生まれる	"to be born"	3
(うけつけ)	受付	"receptionist, reception"	11
(へんじ)	返事	"reply, response"	9
(ようじ)	用事	"errand, business"	9
(かじ)	火事	"fire"	9
(ようてん)	要点	"main point, gist, main idea, essence"	9
(まいど)	毎度	"each time, frequently, every time"	9
(ちょうど)	丁度	"exactly, just"	9
(なんど)	何度	"how many times, how often, what temperature"	9
(ちょうどいい)	丁度いい	"just right, exactly right"	11
(ど)	〜度	"degrees"	9
(かくど)	角度	"angle"	9
(おもて)	表	"front, surface, exterior, face, outside, appearance"	9
(あらわす)	表す	"to express"	9
(かな)	仮名	"kana"	9
(かてい)	仮定	"assumption, hypothesis"	9
(はっけん)	発見	"discovery"	9
(はっぴょう)	発表	"announcement, presentation"	9
(はつおん)	発音	"pronunciation"	9
(はつばいちゅう)	発売中	"now on sale, now for sale, currently on sale"	11
(きもち)	気持ち	"feeling"	9
(にじゅう)	二重	"double, dual"	9
(はなび)	花火	"fireworks"	4
(おもに)	主に	"mainly, primarily"	4
(したく)	支度	"preparation, arrangements, getting ready"	11
(あらかじめ)	予め	"beforehand, in advance, previously, ahead of time"	11
(たいじゅう)	体重	"body weight"	9
(つかいかた)	使い方	"how to use, way of using"	11
(にゅうがく)	入学	"school admission, entry into school, admission into school, school entry, entering a school"	5
(きょう)	今日	"today"	3
(きょうどう)	共同	"cooperation, collaboration, joint"	11
(み)	身	"body, oneself"	8
(おとこのこ)	男の子	"boy"	5
(じじつ)	事実	"truth, fact, reality"	9
(まにあう)	間に合う	"to be in time for, to make it on time, to be on time for"	10
(しゅじん)	主人	"head of household, husband, head of a household, head of the household, landlord, master"	4
(うける)	受ける	"to receive, to accept, to catch"	9
(おんな)	女	"woman, female"	1
(かじ)	家事	"housework, chores"	9
(ぜんりょく)	全力	"full effort, every effort, best effort, full power"	6
(しごと)	仕事	"job, work, occupation"	11
(きんぎょ)	金魚	"goldfish"	7
(やま)	山	"mountain"	1
(はち)	八	"eight"	1
(ななつ)	七つ	"seven things"	1
(てんし)	天使	"angel"	9
(わふく)	和服	"japanese style clothes, japanese clothing, japanese style clothing, japanese clothes"	9
(なな, しち)	七	"seven"	1
(あたらしい)	新しい	"new"	9
(ふたつ)	二つ	"two things"	1
(あめりかじん, アメリカじん)	アメリカ人	"american, american person"	1
(ふたり)	二人	"two people, pair, couple, two persons"	1
(ふらんすじん, フランスじん)	フランス人	"frenchman, french person"	1
(ひとり)	一人	"alone, one person"	1
(ください)	下さい	"please give me, please"	1
(ふじさん)	ふじ山	"mt fuji, mount fuji, mt. fuji"	1
(じゅう)	十	"ten"	1
(あがる)	上がる	"to rise, to go up, to be raised"	1
(かわ)	川	"river"	1
(みっつ)	三つ	"three things"	1
(よんひゃく)	四百	"four hundred"	4
(ふとじ)	太字	"bold letter, bold, bold character, bold text, boldface"	4
(たぶん)	多分	"maybe, perhaps, probably"	5
(じつりょく)	実力	"true strength, true ability, true power"	9
(しんとう)	神道	"shinto, shintou"	11
(きをつけて)	気を付けて	"be careful, take care"	9
(なおる)	直る	"to be fixed, to fix"	6
(こくおう)	国王	"king, monarch, sovereign"	6
(しりあい)	知り合い	"acquaintance"	10
(ひつよう)	必要	"necessary, needed, essential"	9
(ほうげん)	方言	"dialect"	6
(ほんしゅう)	本州	"honshuu, honshu"	6
(たべもの)	食べ物	"food"	9
(みけつ)	未決	"pending, unsettled, undecided, not yet decided"	8
(ふとい)	太い	"fat, thick"	3
(たのしい)	楽しい	"fun"	8
(おんがく)	音楽	"music"	8
(らく)	楽	"comfort, ease, pleasure"	8
(たのしみ)	楽しみ	"looking forward to, hope, expectation, anticipation, pleasure, enjoyment"	10
(たのしむ)	楽しむ	"to enjoy, to enjoy oneself, to have fun"	10
(よっか)	四日	"fourth day, day four, four days"	2
(きた)	北	"north"	3
(あさごはん)	朝ごはん	"breakfast"	8
(あさ)	朝	"morning"	8
(あさひ)	朝日	"morning sun, rising sun"	8
(まいあさ)	毎朝	"every morning"	8
(くみ)	組	"group, team, class"	7
(しょうぶ)	勝負	"match, showdown, contest"	9
(ひっしょう)	必勝	"sure victory, certain victory, sure win, sure victory, certain win"	9
(らくしょう)	楽勝	"easy victory, easy win"	9
(かつ)	勝つ	"to win"	9
(せいぶつ)	生物	"living things, creatures, bio"	9
(こんにちは)	今日は	"hello, good day"	3
(あらた)	新た	"new, fresh, novel, newly, freshly"	11
(ものがたり)	物語	"tale, story, legend"	10
(しゅご)	主語	"subject"	10
(きょく)	局	"bureau, department, station"	8
(じゅうよう)	重要	"essential, important, necessary"	9
(きょうちょう)	強調	"emphasis, highlight, stress"	10
(かりに)	仮に	"temporarily, supposing, for argument's sake"	9
(こころもち)	心持ち	"feeling, mood, somewhat, slightly"	11
(みおくる)	見送る	"to see off"	11
(しんぱい)	心配	"a worry, concern, anxiety, worry"	10
(さっそく)	早速	"at once, immediately, without delay, right away, right now"	10
(ぶん)	文	"writing, sentence"	2
(のむ)	飲む	"to drink"	10
(はしりまわる)	走り回る	"to run around"	8
(くち)	口	"mouth"	1
(ここのつ)	九つ	"nine things"	1
(たいせつ)	大切	"important, precious, valuable"	3
(さん)	三	"three"	1
(すこし)	少し	"a little, a few, few"	3
(もと)	元	"origin"	3
(いっせん)	一千	"one thousand"	2
(がくいん)	学院	"academy, institute"	10
(だいがくいんせい)	大学院生	"graduate student, grad student"	12
(おこる)	起こる	"to occur, to happen, to take place"	12
(もつ)	持つ	"to hold, to carry, to own, to keep"	9
(ひきわけ)	引き分け	"tie, draw"	4
(ちから)	力	"power, strength"	1
(おわる)	終わる	"to end, to finish"	10
(ころぶ)	転ぶ	"to fall over, to fall down"	12
(かいてんずし)	回転ずし	"rotating sushi, conveyor belt sushi, revolving sushi, sushi train, sushi go round"	14
(かいてん)	回転	"rotation, revolution, revolve, rotate"	10
(こんや)	今夜	"tonight, this evening"	6
(いがく)	医学	"medical science, medicine"	8
(じつ)	実	"truth, reality"	9
(しんぶん)	新聞	"newspaper"	10
(うんがいい)	運がいい	"lucky"	10
(うんてんする)	運転する	"to drive"	10
(さいしゅう)	最終	"last, final, the last, the final"	10
(さいきん)	最近	"recent, latest, lately, recently"	10
(もっとも)	最も	"the most, most, extremely"	10
(ふらんすご, フランスご)	フランス語	"french language, french"	10
(にほんご)	日本語	"japanese language, japanese"	10
(よこ)	横	"side, beside, next to"	10
(あげる)	上げる	"to raise, to raise something"	1
(がいらいご)	外来語	"foreign word, borrowed word, loanword"	10
(おきる)	起きる	"to wake up"	10
(さいこう)	最高	"the best, best, supreme, the most, most"	10
(てんそう)	転送	"transfer, forwarding, transmission"	10
(はなし)	話	"story, talk, speech"	10
(かねもち)	金持ち	"rich person, rich, wealthy"	9
(いのち)	命	"life"	11
(きく)	聞く	"to hear, to ask, to listen"	10
(さいご)	最後	"last, the last, end, conclusion, final"	10
(ぶしつ)	部室	"clubroom"	9
(かんがえる)	考える	"to think about, to consider, to give thought"	5
(すえ)	末	"the end, end"	7
(きょく)	曲	"tune, piece of music, song, melody"	6
(はえる)	生える	"to grow, to spring up, to sprout, to come out"	5
(しゅう)	州	"state, province, county"	6
(さゆう)	左右	"left and right, both ways, influence, control"	3
(かい)	会	"meeting, assembly, party"	5
(きゅう, く)	九	"nine"	1
(がいこく)	外国	"foreign country"	6
(きんせい)	金星	"venus"	6
(なんにん)	何人	"how many people"	5
(ひとつ)	一つ	"one thing"	1
(なかなおり)	仲直り	"reconciliation, make peace with"	11
(きょうそう)	競争	"competition"	11
(かたる)	語る	"to talk, to tell, to recite"	10
(はじめる)	始める	"to begin, to start, to begin something, to start something"	9
(ちょうみん)	町民	"townspeople"	7
(にばん)	二番	"number two, second"	8
(ぶ)	〜部	"department, club, category"	9
(くるしむ)	苦しむ	"to suffer, to struggle"	11
(あう)	会う	"to meet, to encounter"	5
(うま)	馬	"horse"	8
(まつり)	祭	"festival"	12
(げんご)	言語	"language, a language"	10
(いと)	糸	"thread"	4
(きょねん)	去年	"last year"	4
(めだま)	目玉	"eyeball"	2
(ろくがつ)	六月	"june"	2
(たいき)	大気	"atmosphere"	4
(ちょうめ)	〜丁目	"district of a town, city block, town district, district"	7
(かたち)	形	"shape, appearance, form"	7
(いる)	要る	"to need"	9
(ねんない)	年内	"within a year, within the year"	4
(ころがる)	転がる	"to roll, to tumble, to lie down, to be scattered about"	10
(いつつ)	五つ	"five things"	2
(りょうほう)	両方	"both, both sides, both ways"	6
(うまれ)	生まれ	"birthplace, birth"	5
(とまる)	止まる	"to stop"	3
(いきる)	生きる	"to live, to be alive, to exist"	3
(さんびゃく)	三百	"three hundred"	6
(ひゃく)	百	"hundred, one hundred"	4
(おとこのひと)	男の人	"man"	5
(もうす)	申す	"to say humbly, to say, to humbly say"	4
(はやく)	早く	"early, soon, quickly, fast"	6
(はやくち, はやぐち)	早口	"fast talker, fast talking, fast speaker, fast speaking, quick talker"	6
(そうそう, はやばや)	早々	"as soon as, just after, immediately after"	4
(せんせい)	先生	"teacher, master, doctor"	4
(つかう)	使う	"to use"	9
(こと)	事	"thing, matter, action"	9
(かち)	勝ち	"victory, win, a victory, a win"	11
(ばりき)	馬力	"horsepower"	8
(てん)	天	"heaven"	2
(はこぶ)	運ぶ	"to carry, to transport, to move"	10
(はじめに)	始めに	"in the beginning, to begin with, to start with"	9
(さくぶん)	作文	"composition, writing, essay"	5
(こうし)	子牛	"calf, baby cow"	4
(ごだい)	五台	"five machines"	3
(にひゃく)	二百	"two hundred"	4
(しゅうてん)	終点	"last stop, final stop"	10
(てんごく)	天国	"kingdom of heaven, heaven"	6
(こうかい)	公開	"open to the public"	10
(な)	名	"name, reputation"	4
(あける)	開ける	"to open, to open something"	10
(あく)	開く	"to open, to be open"	12
(もうしもうし, もしもし)	申し申し	"telephone hello, hello, hello on telephone"	4
(はは)	母	"mother"	3
(あおい)	青い	"blue, unripe"	5
(なんがつ)	何月	"what month, which month"	5
(いいかた)	言い方	"way of saying, way of talking, speaking style"	7
(ひさしぶり)	久しぶり	"long time no see, it's been a while"	3
(いろいろ)	色々	"various"	5
(けい)	〜形	"form, tense"	5
(あてじ)	当て字	"phonetic kanji"	10
(あてる)	当てる	"to guess, to guess something, to hit, to apply"	8
(かい)	貝	"shell, shellfish, clam"	4
(おとうさん)	お父さん	"father, dad, papa"	3
(おとこ)	男	"man"	4
(つくる)	作る	"to make, to build, to create"	5
(けんきゅうしょ, けんきゅうじょ)	研究所	"research institute, research laboratory, research establishment, research lab, research facility"	10
(まる)	丸	"circle, round, circular"	2
(みえる)	見える	"can see, visible, to be visible, to be able to see, able to see"	4
(いちがつ)	一月	"january"	2
(ちゅうい)	注意	"caution, attention"	11
(びょうき)	病気	"sick, illness, sickness, disease"	10
(やむ)	病む	"to be sick, to fall ill, to be ill, to come down with, to suffer from"	10
(だいがくいん)	大学院	"graduate school, grad school"	10
(かんじ)	漢字	"kanji, chinese letters, chinese characters"	10
(せかい)	世界	"the world, society, the universe"	9
(すぺいんご, スペインご)	スペイン語	"spanish language, spanish"	10
(かお)	顔	"face"	10
(かおつき)	顔付き	"expression, facial expression"	10
(おや)	親	"parent"	10
(したしい)	親しい	"intimate, friendly, close"	10
(しんせつ)	親切	"kind, kindness"	10
(のうじょう)	農場	"farm"	10
(かるい)	軽い	"lightweight, light, light weight"	10
(しゅうちゅう)	集中	"concentration"	10
(いちにち, ついたち)	一日	"one day, day one, first day"	2
(しょうねん)	少年	"young boy, juvenile, youth, boy"	4
(とし)	年	"year"	4
(うつ)	打つ	"to hit, to pound, to type"	4
(にせい)	二世	"second generation"	4
(びょういん)	病院	"hospital"	10
(のうぎょう)	農業	"agriculture"	10
(かいぎょう)	開業	"opening a business, opening of business, starting a business"	10
(は)	葉	"leaf, leaves"	10
(ちば)	千葉	"chiba"	10
(ことば)	言葉	"word, language, manner of speech"	12
(ことばつき)	言葉つき	"speech, expression, wording, language, diction"	14
(せん)	線	"line"	10
(きょくせん)	曲線	"curve, curved line"	10
(あたり)	当たり	"a success, success, hit, guess"	5
(ならう)	習う	"to learn"	10
(ふそく)	不足	"shortage, physical shortage, insufficient, not sufficient, not enough"	4
(にほんしゅ, にっぽんしゅ)	日本酒	"japanese style alcohol, japanese alcohol, sake"	10
(でんてつ)	電鉄	"electric railway"	10
(ちかてつ)	地下鉄	"subway, the underground, the metro, the tube"	10
(おさけ)	お酒	"sake, alcohol"	10
(しんか)	進化	"evolution, progress"	10
(びょうにん)	病人	"sick person, patient"	10
(けつぞく)	血族	"blood relative"	12
(ろじ)	路地	"alley, path, dirt road"	10
(たいした)	大した	"considerable, great, important, big deal"	1
(おおきく)	大きく	"in a big way, on a grand scale"	7
(おおいに)	大いに	"very, much, greatly, a lot of, very much"	2
(もくようび)	木曜日	"thursday"	18
(にちようび)	日曜日	"sunday"	18
(しゅざい)	取材	"covering an event, collecting data, data collection"	18
(すいようび)	水曜日	"wednesday"	18
(とりだす)	取り出す	"to pick out, to take out"	18
(とれる)	取れる	"to come off, to be removed, to fall off"	18
(したがき)	下書き	"rough draft"	18
(かきいれる)	書き入れる	"to write in, to fill in"	18
(かきかた)	書き方	"penmanship, way of writing, manner of writing"	18
(らくがき)	落書き	"graffiti, scribble, sketch"	18
(かようび)	火曜日	"tuesday"	18
(きんようび)	金曜日	"friday"	18
(さかえる)	栄える	"to flourish, to prosper"	17
(こうえい)	光栄	"honor, privilege, honour"	17
(えいこう)	栄光	"glory"	17
(むらびと)	村人	"villager"	4
(のりもの)	乗り物	"vehicle"	9
(いろ)	色	"color, colour"	5
(こころ)	心	"heart"	3
(せんじつ)	先日	"the other day, a few days ago, other day"	4
(おとなしい)	大人しい	"obedient, docile, quiet"	3
(けいと)	毛糸	"wool yarn, yarn"	5
(よ)	世	"world, society, age, generation"	4
(おしえ)	教え	"teaching, instruction, teachings, lesson, doctrine"	9
(わかる)	分かる	"to understand"	3
(ふじゆう)	不自由	"discomfort, inconvenience, disability, impairment, poverty, destitution"	9
(けさ)	今朝	"this morning"	10
(なく)	鳴く	"to chirp, to bark, to make an animal sound"	10
(びょう)	秒	"second"	11
(たちのみ)	立ち飲み	"stand and drink, drink while standing, drinking while standing"	10
(ひだり)	左	"left direction, left"	2
(はなみ)	花見	"viewing cherry blossoms, sakura viewing, cherry blossom viewing"	4
(ゆうじん)	友人	"friend"	3
(よのなか)	世の中	"society, the world"	6
(にゅういん)	入院	"hospitalization, hospitalisation, hospital admission, admission to a hospital, institutionalized"	10
(こんど)	今度	"this time, next time"	9
(ちちゅう)	地中	"underground, subterranean"	6
(じてんしゃ)	自転車	"bicycle, bike, pushbike"	10
(そだつ)	育つ	"to be raised"	11
(なま)	生	"fresh, raw"	3
(でかける)	出かける	"to go out, to leave"	4
(ちゅうおう)	中央	"center, central, centre"	4
(まわす)	回す	"to turn, to rotate, to turn something, to rotate something, to spin"	8
(きにいる)	気に入る	"to be pleased with, to be satisfied with, to be happy with, to be pleased, to be satisfied, to be happy"	4
(たいりょく)	体力	"physical strength, physical power"	5
(くうしゃ)	空車	"open taxi, free taxi, empty parking space, open cab, free cab, available taxi, vacant taxi, available cab, vacant cab"	5
(おおぞら)	大空	"heavens, firmament, sky, skies"	7
(うりて)	売り手	"seller, vendor"	5
(うりあげ)	売り上げ	"amount sold, sales"	5
(できあがる)	出来上がる	"to be finished, to be completed"	8
(がいらい)	外来	"imported, outpatient, foreign"	5
(まわる)	回る	"to revolve, to go around, to rotate"	5
(まじわる)	交わる	"to intersect, to cross, to mingle"	8
(まじる)	交じる	"to be mixed, to be blended with, to join"	8
(がいこう)	外交	"diplomacy"	5
(ふべん)	不便	"inconvenient, not convenient"	11
(そら)	空	"sky"	5
(くろう)	苦労	"hardship, troubles"	11
(たに)	谷	"valley"	5
(ほんしゃ)	本社	"headquarters, hq, head office, company headquarters"	5
(くる)	来る	"to come"	5
(まぜる)	交ぜる	"to mix, to mix something"	5
(てつじん)	鉄人	"strong man, badass, iron man, macho man, tough guy"	10
(あかるい)	明るい	"bright"	6
(せんたい)	船体	"hull, ship hull"	7
(てんき)	天気	"weather"	4
(け)	毛	"fur, hair"	3
(しょかい)	初回	"the first time, first time"	11
(じょしゅ)	助手	"assistant, helper, aide"	8
(せいこう)	成功	"success"	11
(けってい)	決定	"decision, determination"	9
(しゅうきん)	集金	"collecting money, money collection"	10
(じょうず)	上手	"good at, skillful, skilled at, skilled"	2
(いちだ)	一打	"strike, stroke, blow"	4
(かいほうする)	開放する	"to open up, to throw open, to open to the public"	11
(はなす)	放す	"to release, to let go, to release something, to let go of something"	11
(ほうそうする)	放送する	"to broadcast"	11
(はなれる)	放れる	"to be released"	13
(うん)	運	"luck"	12
(ははおや)	母親	"mother"	12
(おやぶん)	親分	"boss, kingpin, chief, head"	12
(ちちおや)	父親	"father"	12
(しんぱいする)	心配する	"to worry, to be concerned, to be anxious"	12
(うんてんしゅ)	運転手	"driver"	12
(おち)	落ち	"conclusion, final result, the end, punch line, slip, omission, outcome"	12
(てつだう)	手伝う	"to help, to assist, to lend a hand, to give a hand"	13
(つて)	伝	"intermediary, connections, go between"	15
(こうぎょう)	工業	"industry"	10
(きめる)	決める	"to decide"	8
(だいたい)	大体	"general, approximate, outline, gist"	5
(しゃない)	社内	"within the company, in house, inside the company, inside a company, in the company, within a company"	5
(ほんとうに)	本当に	"really, truly"	7
(いけ)	池	"pond"	5
(していする)	指定する	"to appoint, to assign, to designate, to specify"	11
(こゆび)	小指	"little finger, pinky finger, pinky"	11
(さす)	指す	"to point, to point at"	11
(い)	〜位	"rank"	11
(めいれい)	命令	"order, command"	11
(ひだりきき)	左利き	"left handed"	13
(べんり)	便利	"convenient, handy, useful"	11
(みぎきき)	右利き	"right handed"	13
(むかしばなし)	昔話	"folk tale, legend, old story, folklore"	11
(およぐ)	泳ぐ	"to swim"	9
(ろうじん)	老人	"old person, elderly person"	11
(だす)	出す	"to remove, to hand over, to take out, to reveal"	2
(おおもじ)	大文字	"capital letters, uppercase letters, capital letter, uppercase letter, uppercase, capital"	6
(しゃりょう)	車両	"railroad car, vehicle, train car, railway carriage, railcar"	6
(すべて)	全て	"all, entire"	6
(おやゆび)	親指	"thumb"	11
(つたえる)	伝える	"to transmit, to tell, to pass down, to pass along"	11
(としうえ)	年上	"older"	6
(きゅうしゅう)	九州	"kyuushuu, kyushu"	6
(さけのみ)	酒飲み	"alcoholic, boozer, drunkard"	12
(ず)	図	"diagram"	5
(まち)	町	"town"	4
(あつまる)	集まる	"to come together, to gather, to be gathered"	12
(めいじん)	名人	"master, expert"	4
(いったい)	一体	"the heck, in the world, on earth"	7
(うえ)	上	"up, above, over"	1
(おねえさん)	お姉さん	"older sister, big sister, elder sister"	6
(おと)	音	"sound, noise"	5
(たいりつ)	対立	"confrontation, opposition"	8
(ねんらい)	〜年来	"for some years, for years"	5
(しろい)	白い	"white"	4
(きゅうがく)	休学	"absent from school, absence from school, school absence, leave of absence"	5
(かみ)	紙	"paper"	7
(ほんらい)	本来	"originally, primarily, essentially, naturally"	5
(きんねん)	近年	"recent years"	5
(さと)	里	"home village, village, one's parents' home, home town, hometown"	5
(はやい)	早い	"early, fast, quick"	4
(ひくい)	低い	"low, short"	11
(いま)	今	"now"	3
(かきごおり)	かき氷	"shaved ice"	4
(ひ)	火	"fire"	2
(ひ)	日	"sun, day"	2
(ほどう)	歩道	"sidewalk, footpath, pavement"	8
(ちかみち)	近道	"shortcut, short way"	10
(みち)	道	"road, street, path, way"	8
(どう)	〜道	"method of, way, style, way of"	8
(ほっかいどう)	北海道	"hokkaido, hokkaidou"	8
(ひと)	人	"person"	1
(しこく)	四国	"shikoku"	6
(つよい)	強い	"strong"	7
(いえ, うち)	家	"home, house"	7
(ぶん, ふん)	分	"minute, part"	3
(きみ)	君	"you, buddy"	8
(くん)	〜君	"boy name ender, male name ender, boy name suffix, male name suffix"	8
(くんしゅこく)	君主国	"monarchy"	8
(とり)	鳥	"bird"	7
(つくりかた)	作り方	"how to make, way to make, way of making"	7
(めいきょく)	名曲	"famous music, famous song, famous tune, masterpiece"	6
(たいさく)	大作	"an epic, epic, epic saga, masterpiece, masterwork, magnum opus"	5
(よる)	夜	"night, evening"	6
(べつの)	別の	"separate, different, another, separate thing, different thing, another thing"	11
(べつ)	別	"different, separate"	11
(べつじん)	別人	"different person, changed person, changed man"	11
(べつべつ)	別々	"separately, individually"	11
(べつに)	別に	"not particularly, separately, not really, not exactly, not especially"	11
(ひゃくまん)	百万	"million, one million, a million"	4
(したまち)	下町	"downtown, backstreets"	5
(ぶんがく)	文学	"literature"	5
(だいがくせい)	大学生	"university student, college student, uni student"	7
(こうがく)	工学	"engineering"	5
(きん, かね)	金	"gold"	5
(ふせい)	不正	"injustice, unfairness, dishonesty"	4
(がくせい)	学生	"student"	5
(はたらく)	働く	"to work, to labor, to labour"	11
(おいしい)	美味しい	"tasty, good tasting, delicious"	15
(あじ)	味	"taste, flavor, flavour"	11
(さいしょ)	最初	"the first, first, beginning, outset"	11
(はじめに)	初めに	"beginning, in the beginning, first of all, to begin with"	13
(しょほ)	初歩	"basics, rudiments, elements, abcs"	11
(かぐ)	家具	"furniture"	9
(ようしょく)	洋食	"western food, western style food"	11
(ようふく)	洋服	"clothes, western clothing, western style clothes"	11
(たいへいよう)	太平洋	"pacific ocean"	11
(ようふう)	洋風	"western style"	11
(そそぐ, つぐ)	注ぐ	"to pour"	11
(だいすき)	大好き	"really like, to really like, love, to love, like a lot, to like a lot, like very much, to like very much"	13
(すき)	好き	"like, fondness, love, to like"	11
(はんぶん)	半分	"half"	3
(りょうじつ)	両日	"both days"	6
(おおい)	多い	"many, much, lots of"	5
(した)	下	"down, below, under, beneath"	1
(らいねん)	来年	"next year"	5
(りょうて)	両手	"both hands"	6
(おかあさん)	お母さん	"mother, mom, mum"	3
(ほくせい)	北西	"northwest"	5
(おかね)	お金	"money"	5
(に)	二	"two"	1
(ろうどうしゃ)	労働者	"laborer, blue collar worker, manual laborer, labourer, manual labourer"	11
(なかよし)	仲良し	"good friend, intimate friend, close friend"	11
(よい, いい)	良い	"good"	11
(ゆうこう)	友好	"friendship"	11
(きく)	利く	"to be effective, to show effect"	11
(こうきゅう)	高級	"high class, high grade, high level"	11
(かえる)	返る	"to be returned, to return, to come back"	11
(だいがく)	大学	"university, college"	5
(おもわず)	思わず	"unintentionally, reflexively, spontaneously, involuntarily, instinctively"	10
(たたかう)	戦う	"to fight, to battle, to combat"	13
(むかし)	昔	"long ago, long time ago"	11
(さくせん)	作戦	"tactics, strategy"	11
(なかよく)	仲良く	"friendly, good terms"	11
(さぎょう)	作業	"work, operation, manufacturing"	10
(すすむ)	進む	"to advance, to go forward, to progress"	10
(かい)	〜回	"times, number of times, time"	5
(ごう)	号	"number, edition, model"	4
(からだ)	体	"body"	5
(いちもんじ)	一文字	"straight line"	4
(いう)	言う	"to say"	5
(なんねん)	何年	"what year, how many years"	5
(とうほく)	東北	"northeast, tohoku, tohoku region, touhoku region, touhoku"	6
(こうさく)	工作	"construction, handicraft"	5
(とうきょう)	東京	"tokyo, toukyou"	6
(ごうしつ)	〜号室	"room number counter, counter for room numbers, suffix for room numbers, room number"	7
(ゆうめい)	有名	"famous"	6
(せんしゃ)	戦車	"tank"	11
(きそう)	競う	"to compete"	11
(にゅうりょく)	入力	"input, enter"	2
(いりぐち)	入り口	"entrance"	1
(いれる)	入れる	"to insert, to put in"	1
(さいてい)	最低	"the lowest, the worst, lowest, worst, nasty, terrible"	11
(まちぼうけ)	待ちぼうけ	"stood up, waiting in vain"	11
(いちい)	一位	"first place, first ranked"	11
(なる)	鳴る	"to ring"	12
(ちきゅう)	地球	"the earth, the globe, earth"	12
(むしば)	虫歯	"cavity, decayed tooth"	12
(ひがし)	東	"east"	6
(とくに)	特に	"especially, particularly"	11
(あたりまえ)	当たり前	"natural, reasonable, obvious, usual, common, ordinary"	8
(ばい)	〜倍	"times, fold"	12
(こうどう)	行動	"action, conduct, behaviour, behavior"	12
(おもい)	重い	"heavy"	9
(あたま)	頭	"head"	10
(にばい)	二倍	"double, two times, twice"	12
(しょうかふりょう)	消化不良	"indigestion"	14
(けす)	消す	"to extinguish, to erase, to turn off"	12
(けしごむ, けしゴム)	消しゴム	"eraser, rubber"	14
(しょうか)	消化	"digestion"	12
(のうみん)	農民	"peasants, farmers"	10
(にがつ)	二月	"february"	2
(いっかい)	一回	"one time, once"	5
(いずみ)	泉	"spring, fountain"	12
(きる)	着る	"to wear, to put on"	12
(したぎ)	下着	"underwear"	12
(つける)	着ける	"to put on, to wear, to pull up"	14
(おちつく)	落ち着く	"to calm down"	14
(みずぎ)	水着	"swim suit, swimsuit, bathing suit, swimwear, swimming suit"	12
(きもの)	着物	"kimono, clothes"	12
(しょうばい)	商売	"business, commerce"	12
(まなぶ)	学ぶ	"to learn, to study in depth, to study"	5
(おおごえ)	大声	"large voice, loud voice, big voice"	5
(ふね)	船	"boat, ship"	7
(よんせん)	四千	"four thousand"	2
(しゅうまつ)	週末	"weekend"	7
(じゅうにん)	住人	"resident, inhabitant, dweller"	8
(じゅうみん)	住民	"residents, citizens"	9
(りゆう)	理由	"reason"	7
(かいしゃ)	会社	"company, corporation, the office"	5
(じゆう)	自由	"freedom"	7
(しぐさ)	仕草	"action, acting, gesture, bearing, treatment, behavior, behaviour, movement"	5
(いっかい)	一階	"first floor, floor one, first story, ground floor"	12
(かぞく)	家族	"family, immediate family"	12
(みんぞく)	民族	"ethnic group, ethnicity, race"	12
(さきまわり)	先回り	"anticipation, anticipate, going ahead, arriving ahead"	7
(さげる)	下げる	"to lower, to hang, to lower something, to hang something"	1
(じゅうまん)	十万	"one hundred thousand, hundred thousand, a hundred thousand"	3
(さがる)	下がる	"to get lower, to fall, to drop, to come down, to hang down"	1
(ふうせん)	風船	"balloon"	7
(きじ)	記事	"article, news story, report, account, news article"	9
(らいしゅう)	来週	"next week"	7
(こえ)	声	"voice"	5
(としした)	年下	"younger"	6
(ふかさ)	深さ	"depth, profundity"	14
(しんや)	深夜	"middle of the night, late at night"	12
(すいしん)	水深	"water depth, depth of water"	12
(ふかい)	深い	"deep"	12
(きょういく)	教育	"education"	11
(みじかい)	短い	"short"	12
(やね)	屋根	"roof"	12
(だいこん)	大根	"daikon, japanese radish"	12
(こんき)	根気	"patience, perseverance, persistence"	12
(しゃいん)	社員	"employee, staff, company employee, company staff"	12
(かいいん)	会員	"member, membership"	12
(せんいん)	船員	"sailor, seaman, mariner, crewman"	12
(びーだま, ビーだま)	ビー玉	"marble"	2
(あとで)	後で	"after, afterwards, later"	6
(くるま)	車	"car"	4
(とうほう)	東方	"eastward, eastern direction, touhou"	6
(ち)	血	"blood"	6
(たしろじま)	田代島	"tashirojima"	12
(しま)	島	"island"	12
(いままで)	今まで	"until now, up to now, so far"	5
(かもく)	科目	"subject, course, curriculum"	8
(さとごころ)	里心	"homesick, homesickness"	5
(ちかい)	近い	"close, nearby, near"	5
(おとな)	大人	"adult"	1
(ぜんかい)	前回	"last time"	8
(なまえ)	名前	"name, first name, full name, given name"	8
(おまえ)	お前	"you"	8
(ちゃいろ)	茶色	"brown, brown colour, brown color, color brown, colour brown"	6
(みなおす)	見直す	"to reevaluate, to look again, to reassess"	8
(なおす)	直す	"to fix, to repair"	6
(みなみぐち)	南口	"south exit, south entrance, southern exit, southern entrance, south gate"	8
(いけん)	意見	"opinion, view"	11
(むけ)	〜向け	"made for, intended for, aimed at"	10
(むける)	向ける	"to turn towards, to point, to turn (something) towards"	8
(ほうこう)	方向	"direction"	6
(あんぜん)	安全	"safety"	6
(かんがえ)	考え	"thought, a thought"	5
(つぎつぎ)	次々	"one by one, in succession, one after the other"	8
(じかい)	次回	"next time"	6
(びょう)	〜病	"disease, sickness, illness"	10
(くび)	首	"neck"	6
(くびになる)	首になる	"to get fired, to be fired"	6
(てくび)	手首	"wrist"	6
(しゅっけつ)	出血	"bleeding, bleed"	6
(ながさ)	長さ	"length"	8
(くうこう)	空港	"airport"	12
(きづく)	気付く	"to realize, to notice, to realise"	11
(なくなる)	亡くなる	"to pass away, to become deceased, to die"	6
(つける)	点ける	"to turn on, to switch on, to light up"	8
(しぬ)	死ぬ	"to die"	6
(し)	死	"death"	6
(あんしん)	安心	"relief, peace of mind"	6
(やすい)	安い	"cheap, inexpensive"	6
(やすうり)	安売り	"sell cheaply, discount, bargain sale, sale"	8
(しょうじき)	正直	"honest"	6
(てん)	点	"point, decimal, decimal point"	6
(しゃちょう)	社長	"company president, manager, director, president of a company"	6
(へいじつ)	平日	"weekdays"	4
(たべる)	食べる	"to eat"	6
(かがく)	科学	"science"	6
(にゅうしゃ)	入社	"joining a company, entering a company"	5
(へいあん)	平安	"peace, tranquility, heian"	6
(せんせんげつ)	先々月	"month before last, the month before last"	4
(あかい)	赤い	"red"	4
(みみ)	耳	"ear"	4
(ゆ)	湯	"hot water"	12
(やまのぼり)	山登り	"mountain climbing"	14
(ぶんかさい)	文化祭	"school festival, culture festival, arts festival"	14
(りゅうこうご)	流行語	"popular phrase, catchphrase"	14
(りゅうこうか)	流行歌	"popular song"	14
(ながれる)	流れる	"to stream, to flow"	14
(ほんりゅう)	本流	"mainstream"	12
(わるぎ)	悪気	"evil intent, malice"	14
(きもちわるい)	気持ち悪い	"to feel terrible, terrible, to feel bad, bad feeling, feeling bad, feeling terrible"	14
(いじわる)	意地悪	"malicious, mean, jerk"	14
(あくじょ)	悪女	"evil woman, wicked woman, bad woman"	12
(べんきょう)	勉強	"studies, study"	12
(べんきょうする)	勉強する	"to study"	14
(たま, きゅう)	球	"sphere, ball, sports ball"	12
(ちゃのゆ)	茶の湯	"tea ceremony"	12
(ちょっこう)	直行	"nonstop, direct"	6
(やきゅう)	野球	"baseball"	12
(かい)	〜階	"floor, story, storey"	12
(とざん)	登山	"mountain climbing"	12
(さいしん)	最深	"deepest, the deepest"	12
(たんとう)	短刀	"short sword, dagger, tanto"	12
(ふあん)	不安	"uneasiness, anxiety, unease"	6
(あしくび)	足首	"ankle"	6
(ながす)	流す	"to flow, to flush, to drain, to pour, to float, to wash away, to set afloat"	12
(かいしゃいん)	会社員	"company employee, office worker"	12
(ね)	根	"root"	12
(あくにん)	悪人	"bad person, villain, evildoer, bad guy, wicked person, evil person"	12
(あんき)	暗記	"memorization, memorize, memorisation, memorise"	13
(やっつ)	八つ	"eight things"	1
(しょうかする)	消化する	"to digest"	14
(なんぜん)	何千	"thousands"	5
(むすこ)	息子	"son"	12
(がっき)	学期	"school term, semester"	12
(たんき)	短期	"short period, short term"	12
(どうきちゅう)	同期中	"syncing, synchronizing"	15
(きたい)	期待	"expectation, expect, anticipate"	12
(りょうしゃ)	両者	"both people"	8
(あたたかい)	温かい	"warm"	12
(あたためる)	温める	"to warm up, to warm, to heat up, to heat"	14
(きおん)	気温	"temperature"	12
(ほんかん)	本館	"main building"	13
(しんよう)	信用	"trust, confidence"	15
(うえる)	植える	"to plant, to grow"	12
(うんめい)	運命	"fate, destiny"	11
(しまい)	姉妹	"sisters"	6
(たす)	足す	"to add"	6
(しゅうでん)	終電	"last train, the last train"	12
(まがる)	曲がる	"to be bent, to bend, to curve, to turn"	8
(かいがい)	海外	"overseas, foreign, abroad"	6
(うみ)	海	"ocean, sea"	6
(ひがしぐち)	東口	"east exit, east entrance, eastern exit, eastern entrance, east gate"	8
(にちじょう)	日常	"everyday life, normal life, daily life, ordinary, regular, everyday, usual"	17
(ひじょう)	非常	"emergency"	17
(つねに)	常に	"always, usually, ordinarily"	17
(こうばん)	交番	"police box"	8
(かみさま)	神様	"god, gods"	13
(おとす)	落とす	"to drop something, to let fall, to drop, to fall"	12
(ようい)	用意	"preparation, arrangements, provision, getting ready"	11
(じぶん)	自分	"oneself, myself, self"	5
(おいかける)	追いかける	"to follow, to stalk, to chase, to run after, to pursue"	13
(おんせん)	温泉	"hot springs, onsen"	12
(こいぬ)	子犬	"puppy"	2
(わるくち, わるぐち, あっこう)	悪口	"verbal abuse, saying bad things, insult, slander, bad mouth"	14
(なんべい)	南米	"south america"	8
(もちいる)	用いる	"to utilize, to use, to utilise"	3
(ばんにん)	万人	"all people, everybody"	5
(だいいちい)	第一位	"first place, first rank"	12
(にんげん)	人間	"human, human being"	8
(ちゅうこ)	中古	"secondhand, used, second hand"	3
(ちか)	地下	"underground, basement, cellar"	6
(ちじょう)	地上	"above ground, on the ground"	8
(きじ)	生地	"material, cloth, fabric, dough, batter"	8
(きょうつうてん)	共通点	"common point, common feature"	11
(おもう)	思う	"to think"	6
(うつる)	写る	"to be photographed"	4
(ぜんこく)	全国	"nationwide, national, countrywide"	6
(あつい)	暑い	"hot weather, hot"	12
(じんせい)	人生	"one's life, human life"	3
(おう)	王	"king"	2
(かつようけい)	活用形	"conjugated form"	7
(にがて)	苦手	"hard to deal with, weak point, poor at, not very good at, bad at"	11
(はくじん)	白人	"caucasian, white person, white people"	2
(いし)	石	"stone"	2
(とくべつ)	特別	"special"	11
(ひらがな)	平仮名	"hiragana"	11
(なんじ)	何時	"what time"	7
(じ)	〜時	"o'clock, time, hour"	7
(とき)	時	"time, hour"	7
(にじはん)	二時半	"two thirty, half past two, half two"	7
(ゆき)	雪	"snow"	7
(たび)	旅	"trip, travel"	12
(たいよう)	太陽	"sun, the sun, sol"	12
(ひっし)	必死	"frantic, desperate, certain death, sure death"	7
(かならず)	必ず	"surely, certainly, without exception, always, definitely"	7
(あるく)	歩く	"to walk"	6
(いぜん)	以前	"previously, before"	7
(いがい)	以外	"other than, excepting, except for"	7
(たかさ)	高さ	"height"	9
(よわい)	弱い	"weak"	7
(せいかつ)	生活	"life, livelihood"	6
(しめい)	氏名	"full name, first and last name"	7
(し)	氏	"mister, sir, ma'am, madam, miss"	7
(せんしゅう)	先週	"last week"	7
(がいこくじん)	外国人	"foreign person, foreigner"	6
(うる)	売る	"to sell"	5
(なつやすみ)	夏休み	"summer vacation, summer break, summer holiday"	7
(なつ)	夏	"summer"	7
(みぎて)	右手	"right hand"	2
(いっしょう)	一生	"whole life, entire life, a lifetime, all through life, one existence, a generation, an age"	5
(みらい)	未来	"future, the future, distant future, the distant future"	7
(がっこう)	学校	"school"	7
(ちゅうがっこう)	中学校	"middle school, junior high school"	9
(せんえんさつ)	千円札	"thousand yen bill, thousand yen note, one thousand yen note, one thousand yen bill"	7
(おしえる)	教える	"to teach"	7
(さよう)	作用	"action, effect, operation"	5
(しんりがく)	心理学	"psychology"	7
(しんり)	心理	"mental state, psychology"	7
(ちり)	地理	"geography"	7
(じゅうがつ)	十月	"october"	2
(うし)	牛	"cow"	3
(みなみ)	南	"south"	6
(あたり)	辺り	"area, vicinity, neighborhood"	7
(いく)	行く	"to go"	5
(ほし)	星	"star"	6
(なんとう)	南東	"southeast"	6
(きょうだい)	兄弟	"siblings, brothers and sisters"	5
(やすむ)	休む	"to rest"	4
(かなしみ)	悲しみ	"sadness, sorrow, grief, unhappiness, distress"	14
(こうこう)	高校	"high school"	7
(このへん)	この辺	"around here, this area"	7
(にし)	西	"west"	5
(こめ)	米	"rice"	5
(かよう)	通う	"to commute, to attend, to go back and forth"	11
(じだい)	時代	"period, epoch, era, time period"	7
(みずいろ)	水色	"sky blue, light blue, light blue color, light blue colour, sky blue color, sky blue colour"	5
(おんなのひと)	女の人	"woman"	3
(まだ)	未だ	"not yet, still"	7
(しぼう)	死亡	"mortality, death"	6
(へん)	辺	"area, vicinity, region"	7
(いちまん)	一万	"ten thousand"	3
(そと)	外	"outside"	3
(げつまつ)	月末	"end of the month, month end"	7
(かなしい)	悲しい	"sad"	12
(みあたる)	見当たる	"to be found, to come upon, to come across"	7
(とうきょうと)	東京都	"tokyo metropolis, tokyo metro, tokyo metropolitan area, tokyo metro area"	12
(さんばんめ)	三番目	"third thing, the third"	12
(はじめて)	初めて	"for the first time, first time"	13
(ゆびさき)	指先	"fingertip"	11
(ひかり)	光	"light, sunlight"	5
(こうこがく)	考古学	"archeology, archaeology"	7
(てづくり)	手作り	"handmade, homemade"	7
(くうき)	空気	"air, atmosphere"	5
(げっこう)	月光	"moonlight, moonbeam"	5
(むぎ)	麦	"wheat, barley, oats"	5
(にんぎょう)	人形	"doll, puppet"	7
(きょうしつ)	教室	"classroom"	7
(かいぎょ, うみざかな)	海魚	"ocean fish, saltwater fish"	7
(とち)	土地	"land"	6
(すいせい)	水星	"mercury"	6
(ぶんか)	文化	"culture"	6
(ひろい)	広い	"wide, spacious"	3
(すくない)	少ない	"a few, few, scarce, not much, not many"	3
(おちゃ)	お茶	"tea"	6
(たいいく)	体育	"pe class, pe, physical education, gym class"	13
(わかれる)	別れる	"to separate, to be divided, to part from"	13
(しょうがっこう)	小学校	"elementary school, primary school, grade school"	9
(ひつじ)	羊	"sheep"	6
(いちじ)	一時	"one o'clock, one hour"	7
(むく)	向く	"to face, to turn toward"	6
(しょうじょ, おとめ)	少女	"young lady, little girl, maiden, girl"	3
(こくじん)	黒人	"black person, black people"	7
(どうじ)	同時	"same time"	7
(おんど)	温度	"temperature"	12
(きかん)	期間	"period, term, interval, span"	12
(もり)	森	"woods, forest"	8
(いもうと)	妹	"younger sister, little sister"	6
(ところ)	所	"place, spot, scene"	8
(だいどころ)	台所	"kitchen"	10
(にゅうしょ)	入所	"admission, entrance, imprisonment, internment"	8
(しゅっしょ)	出所	"source, origin, place of origin"	8
(あね)	姉	"older sister, big sister, elder sister"	6
(たかい)	高い	"tall, high, expensive"	7
(いか)	以下	"less than, or less, not exceeding, below"	7
(ながい)	長い	"long"	6
(おしらせ)	お知らせ	"notice, notification, flier, pamphlet, handbill, flyer, leaflet"	8
(はんたい)	反対	"opposition, opposite"	8
(ひかる)	光る	"to shine, to glitter"	7
(できる)	出来る	"to be able to do"	6
(ちかく)	近く	"near, neighbourhood, neighborhood, vicinity, nearly, shortly"	7
(しょうがくせい)	小学生	"elementary school student, primary school student, elementary schooler, primary schooler, grade schooler, grade school student"	7
(だいにしょう)	第二章	"chapter two, second chapter"	12
(ぶんしょう)	文章	"writing, article, sentence, composition"	12
(ごぜん)	午前	"am, morning, a.m."	6
(おこなう)	行う	"to carry out a task, to carry out, to perform, to perform a task, to do a task"	5
(ちゅうとう)	中東	"middle east"	6
(つち)	土	"soil, earth, ground, dirt"	2
(かいおうせい)	海王星	"neptune"	6
(つたわる)	伝わる	"to be transmitted"	13
(いき)	息	"breath"	12
(にゅうかんりょう)	入館料	"admission fee, entrance fee, entry fee"	13
(りょうきん)	料金	"fee, bills, fees, bill"	13
(りょうりにん)	料理人	"a cook, cook, chef"	16
(りょうり)	料理	"cooking, cuisine, cookery"	14
(たいやく)	大役	"important task, great duty, important role"	8
(つぎ)	次	"next"	6
(こらい)	古来	"ancient"	5
(もくじ)	目次	"table of contents"	6
(みなと)	港	"harbor, harbour, port"	12
(へいき)	平気	"calm, cool, all right, okay"	4
(けっていする)	決定する	"to decide, to determine"	11
(ふだ)	〜札	"label, bill, note"	7
(りょこう)	旅行	"trip, travel"	12
(せいぞん)	生存	"existence, life, survival"	16
(じき)	時期	"time, season, period, time period, period of time"	12
(じんこう)	人工	"artificial, man made, human made"	1
(おおきい)	大きい	"big, large"	1
(ごひゃく)	五百	"five hundred"	4
(ことし, こんねん)	今年	"this year"	6
(うれる)	売れる	"to be sold, to sell"	7
(はやし)	林	"forest, woods"	5
(なんにち)	何日	"how many days, what day, which day"	5
(みせ)	店	"shop, store"	6
(じゃくてん)	弱点	"weak point, weakness"	7
(けってん)	欠点	"shortcoming, fault, defect, flaw, weakness, weak point"	7
(ねんまつ)	年末	"year end, end of the year, end of year"	7
(たしょ, よそ)	他所	"another place, somewhere else, other place, elsewhere"	8
(きんじょ)	近所	"neighborhood, neighbourhood"	10
(でんし)	電子	"electron, electronic"	8
(でんしゃ)	電車	"train"	8
(でんち)	電池	"battery"	8
(でんりょく)	電力	"electric power"	8
(でんき)	電気	"electricity, light"	8
(のる)	乗る	"to ride"	9
(わしょく)	和食	"japanese style food, japanese food"	9
(おきゃくさん)	お客さん	"guest, visitor, customer"	9
(しょくじ)	食事	"meal"	9
(べんじょ)	便所	"toilet, lavatory, restroom, bathroom"	11
(このむ)	好む	"to be fond of, to like"	15
(はいしゃ)	歯医者	"dentist"	12
(かつどう)	活動	"action, activity"	12
(うごき)	動き	"movement, activity, trend, development, change"	14
(じどう)	自動	"automatic"	14
(うんどうかい)	運動会	"sports day"	14
(どうぶつ)	動物	"animal"	12
(よんじゅうにかい)	四十二階	"forty second floor, floor forty two, 42nd floor, floor 42, forty second story, forty second storey"	12
(にかい)	二階	"second floor, floor two, second story, second storey"	12
(ゆげ)	湯気	"steam, vapor"	12
(だいいち)	第一	"the first, first, number one, best"	12
(りょこうする)	旅行する	"to travel, to take a trip"	14
(りょこうしゃ)	旅行者	"traveler, tourist"	14
(つごう)	都合	"at your convenience, circumstance"	14
(とかい)	都会	"city, town, urban, civilization"	12
(とし)	都市	"city, a city, town, municipal, urban"	12
(ざんぎょう)	残業	"overtime"	14
(のこる)	残る	"to remain behind, to remain, to stay behind"	14
(まいばん)	毎晩	"every night, nightly"	15
(たいへん)	大変	"serious, terrible, very, difficult, hard, hectic"	15
(なきごえ)	泣き声	"crying, sob"	17
(たてまえ)	建前	"public behavior, public behaviour, official stance, public position, public face, tatemae"	17
(がんじょう)	頑丈	"solid, firm, stout, sturdy"	15
(いさむ)	勇む	"to be encouraged, to be lively, to be in high spirits, to cheer up, to be excited, to be inspired"	17
(なげる)	投げる	"to throw, to throw something"	8
(こんばんは)	今晩は	"good evening"	15
(じへん)	事変	"incident"	15
(おっと)	夫	"husband"	15
(だいじょうぶ)	大丈夫	"safe, all right, okay"	18
(とる)	取る	"to take"	16
(しょうしゃ)	勝者	"winner, victor"	9
(なきごえ)	鳴き声	"animal cry, animal sound, animal noise, chirp, tweet, roar, bark, meow"	12
(おわり)	終わり	"the end, end, the finish, finish"	12
(いみ)	意味	"meaning"	11
(かおもじ)	顔文字	"kaomoji"	12
(のりば)	乗り場	"bus stop, taxi stand, train platform, place for boarding vehicles"	11
(はなしかた)	話し方	"way of speaking, speaking style, way of talking, talking style"	12
(こうきょう)	公共	"public, community"	11
(こたえる)	答える	"to answer, to reply, to respond"	8
(かぜ)	風	"wind"	7
(こんかい)	今回	"this time"	5
(いちりゅう)	一流	"first rate, first class, top notch, top grade"	12
(うたう)	歌う	"to sing"	12
(そくど)	速度	"speed"	10
(でんぱ)	電波	"reception, radio wave, electromagnetic wave"	11
(かみ)	神	"god, gods"	11
(かって)	勝手	"as one pleases, one's own convenience, one's own way, one's way"	12
(はなつ)	放つ	"to fire, to hit, to break wind"	15
(めいじ)	明治	"meiji era, meiji emperor, meiji"	16
(しらべる)	調べる	"to investigate, to examine, to research, to look into, to search"	10
(へんし)	変死	"unnatural death, accidental death"	15
(ゆび)	指	"finger"	11
(うち)	内	"inside, within"	3
(いじょう)	以上	"more than, or more, that's all"	7
(くちょう)	口調	"tone, tone of voice, verbal expression"	10
(わしつ)	和室	"japanese style room"	9
(とっきゅう)	特急	"limited express train, limited express"	16
(たもつ)	保つ	"to preserve, to keep, to maintain"	16
(じてん)	事典	"encyclopedia"	16
(たいがい)	対外	"foreign, overseas"	8
(さか)	坂	"slope"	15
(いちばんめ)	一番目	"first thing, the first"	10
(かいはつ)	開発	"development"	10
(しょうめい)	証明	"proof, verification"	16
(ほしょう)	保証	"guarantee"	16
(しょうげん)	証言	"testimony"	16
(ぞんじる)	存じる	"to know, to be aware of"	16
(きたいする)	期待する	"to expect, to anticipate"	14
(つく)	着く	"to arrive"	12
(けつ)	決	"decision"	8
(かんどうする)	感動する	"to be emotionally moved, to be moved emotionally, to be moving"	13
(るす)	留守	"absence, away from home"	16
(りゅうがく)	留学	"study abroad, studying abroad"	16
(りゅうがくせい)	留学生	"exchange student, international student, foreign student"	18
(るすばん)	留守番	"caretaker, housesitting, looking after one's house"	18
(あいて)	相手	"partner, companion"	9
(ふほう)	不法	"illegal, unlawful"	15
(わるい)	悪い	"bad, poor, wrong"	12
(そうぞうする)	想像する	"to imagine"	13
(きょうと)	京都	"kyoto, kyouto"	12
(そうこう)	走行	"traveling, travelling"	5
(ばかす)	化かす	"to bewitch, to enchant"	10
(みょうじ)	名字	"surname, last name, family name"	4
(なかなか)	中々	"very, considerably, quite"	2
(なる)	成る	"to become"	11
(せじ)	世辞	"flattery, compliment"	16
(だいじ)	大事	"important, valuable, serious matter"	9
(にがい)	苦い	"bitter tasting, bitter"	9
(そつぎょう)	卒業	"graduation"	14
(あつめる)	集める	"to collect, to gather, to assemble"	10
(おいつく)	追い付く	"to catch up to, to overtake"	13
(せんじょう)	戦場	"battlefield, battleground"	11
(こうじ)	工事	"construction"	9
(かいてんする)	回転する	"to rotate, to revolve"	14
(ばける)	化ける	"to transform"	8
(いっぽんぎ)	一本気	"one track mind, single mindedness"	4
(せんそう)	戦争	"war"	11
(ひきざん)	引き算	"subtraction"	10
(ひろしま)	広島	"hiroshima"	12
(しぜん)	自然	"nature, natural"	13
(はつばい)	発売	"for sale, selling, item for sale, sale"	9
(むいか)	六日	"sixth day, day six, six days"	2
(じょせい)	女性	"female, woman, lady"	14
(しんじつ)	真実	"truth, reality"	16
(じょうひん)	上品	"elegant"	18
(なか)	中	"middle, in, inside, center"	2
(しろ)	白	"white"	2
(よてい)	予定	"a plan, plan"	9
(ぜんめん)	前面	"front, front side"	16
(がめん)	画面	"screen, monitor"	16
(じめん)	地面	"ground, earth's surface"	16
(かめん)	仮面	"mask"	16
(がいめん)	外面	"exterior"	16
(ぜんいん)	全員	"all members, all hands, everyone, everybody"	12
(りょうこう)	良好	"good, favorable, satisfactory"	14
(もん)	門	"gate"	16
(にゅうもん)	入門	"admission, entrance"	16
(はし)	橋	"bridge"	13
(かんしん)	関心	"concern, interest"	16
(さっか)	作家	"author, writer, novelist"	7
(まもる)	守る	"to protect, to defend"	16
(ねんじゅう)	年中	"year round, all year, whole year, throughout the year, all year round"	4
(ぜんち, ぜんじ)	全治	"complete recovery, healed, fully recovered, fully recover, healed completely, heal completely, completely cured, fully cured, fully healed"	16
(うごく)	動く	"to move, to operate"	12
(ほね)	骨	"bone"	14
(えいぞう)	映像	"reflection, image"	13
(しゅうちゅうする)	集中する	"to concentrate"	11
(とおい)	遠い	"far, far away"	16
(びじゅつ)	美術	"fine art"	14
(ようきゅうする)	要求する	"to demand"	16
(いそぐ)	急ぐ	"to hurry"	16
(たたかい)	戦い	"battle, fight, conflict"	11
(おんよみ)	音読み	"chinese reading, on'yomi"	12
(もくざい)	木材	"wood, lumber"	14
(じてん)	字典	"character dictionary, kanji dictionary"	16
(ちょうし)	調子	"condition"	10
(かいもの)	買い物	"shopping"	10
(は)	歯	"tooth, teeth"	12
(はこ)	箱	"box"	16
(りそく)	利息	"interest"	12
(ひとごろし)	人殺し	"murder, murderer"	15
(しんじる)	信じる	"to believe, to trust in"	15
(ほけん)	保険	"insurance"	16
(ぼうけん)	冒険	"adventure"	16
(きけん)	危険	"risky, unsafe, dangerous, danger, peril, hazard"	16
(ほしゅてき)	保守的	"conservative"	16
(さむい)	寒い	"cold"	12
(へんか)	変化	"change, transformation"	15
(しろくろ)	白黒	"black and white, white and black"	9
(このまえ)	この前	"last time, recently, lately, previous, previously"	8
(きぼう)	希望	"hope, wish, aspiration"	14
(かく)	書く	"to write"	16
(しょうめいしょ)	証明書	"certificate, credentials"	18
(としょかん)	図書館	"library"	16
(したい)	死体	"dead body, corpse, cadaver"	6
(きぶん)	気分	"feeling, mood"	4
(でる)	出る	"to exit, to leave, to attend, to come out, to go out"	2
(けいさつ)	警察	"police"	17
(あたる)	当たる	"to be on target, to hit, to touch, to guess correctly, to guess right, to be right, to hit the target"	5
(そだてる)	育てる	"to bring up, to raise, to bring something up, to raise something"	13
(のぼる)	登る	"to climb, to ascend"	12
(しゅくだい)	宿題	"homework"	13
(たば)	束	"bundle"	14
(よろこぶ)	喜ぶ	"to rejoice, to become happy"	16
(よろこび)	喜び	"joy, delight, glee, rapture, pleasure, satisfaction, gratification, rejoicing, congratulations"	18
(ときどき)	時々	"sometimes, at times"	11
(うんどう)	運動	"exercise"	12
(なかゆび)	中指	"middle finger, second finger"	11
(こうしゃ)	公社	"public corporation, public company, government agency, federal agency"	5
(ゆうき)	勇気	"courage, bravery, valour, valor"	15
(しりつだいがく)	私立大学	"private college, private university"	16
(さき)	先	"previous, ahead, past, former"	4
(はずれる)	外れる	"to be disconnected, to come off, to be out, to be off"	3
(こうえん)	公園	"public park, park"	16
(どうぶつえん)	動物園	"zoo, zoological gardens, menagerie"	16
(りゅうこう, はやり)	流行	"trend, fad, craze"	12
(がんめん)	顔面	"face of a person, person's face, face"	16
(きょうかしょ)	教科書	"textbook"	16
(げひん)	下品	"crude, vulgarity"	16
(えん, その)	園	"garden, park"	16
(あかし)	証	"evidence, proof"	16
(いぎりすじん, イギリスじん)	イギリス人	"british person, english person"	17
(ばめん)	場面	"scene, setting, locale"	16
(こうふく)	幸福	"happiness"	16
(しあわせ)	幸せ	"happiness"	16
(ふこう)	不幸	"unhappiness, misfortune"	16
(さいわい)	幸い	"happiness, luck, fortune"	18
(こううん)	幸運	"good luck, fortune"	16
(しょうにん)	証人	"witness"	16
(なきむし)	泣き虫	"crybaby"	17
(しょくぶつ)	植物	"plant, vegetation"	12
(さっする)	察する	"to guess, to sense, to presume"	17
(にんずう)	人数	"the number of people, number of people, the amount of people, amount of people"	8
(きげんご)	紀元後	"ad, anno domini, after death, ce, common era"	15
(のうりょく)	能力	"ability, capability"	14
(かんけつ)	完結	"conclusion, completion, ending, consummation"	17
(しあとるし, シアトルし)	シアトル市	"seattle, city of seattle"	3
(はくちょう)	白鳥	"swan"	7
(さくひん)	作品	"a work, work, production"	16
(じどうしゃ)	自動車	"automobile"	16
(しょくりょうひん)	食料品	"groceries"	16
(にっこうよく)	日光浴	"sunbathe"	16
(すいどう)	水道	"water supply, water service, waterworks, aqueduct, conduit, water line"	8
(くうせき)	空席	"open seat, empty seat, free seat"	17
(むちゃ)	無茶	"absurd, rash, excessive"	17
(そとがわ)	外側	"outside"	17
(のぼる)	上る	"to climb, to go up"	1
(さいあく)	最悪	"the worst, worst"	12
(かんてん)	干天	"dry weather, drought"	17
(ねつ)	熱	"fever, heat"	13
(とおす)	通す	"to let pass, to overlook, to continue, to keep, to make way for, to persist in"	9
(ねんがん)	念願	"heart's desire, earnest wish"	14
(ちゅうし)	中止	"suspension, stoppage, discontinuance, interruption"	3
(とおく)	遠く	"far away, distant, at a distance, distant place, by far"	16
(せんもん)	専門	"specialty, speciality, area of study, major"	16
(こうこうせい)	高校生	"high school student, high schooler"	9
(うしなう)	失う	"to lose, to part with, to lose something, to part with something"	7
(いがい)	意外	"unexpected"	11
(ようき)	陽気	"cheerful, jovial, merry, lively, spring season, warm weather"	12
(あいじん)	愛人	"lover, mistress"	17
(じしょ)	辞書	"dictionary"	16
(かてい)	家庭	"family, household"	12
(しんぴん)	新品	"brand new, new item, new product"	16
(あびる)	浴びる	"to bathe"	16
(ざんぴん)	残品	"unsold merchandise, remaining stock, unsold stock, remaining merchandise, unsold product, remaining product"	16
(えがお)	笑顔	"smile, smiling face"	16
(わらう)	笑う	"to laugh"	16
(わらい)	笑い	"a laugh, laugh"	18
(おわらい)	お笑い	"comedy, joke, funny story"	18
(てんいん)	店員	"shop staff, store staff, store employee, shop employee, clerk, salesperson, shop assistant"	12
(とくぎ)	特技	"specialty, speciality"	14
(ふゆ)	冬	"winter"	3
(こんぽん, ねもと)	根本	"root, source, origin, foundation"	12
(さんせい)	三世	"third generation"	4
(まずい)	不味い	"bad tasting, unappetizing, unskillful"	17
(さくねん)	昨年	"last year"	15
(しょきゅう)	初級	"beginner level, elementary level, beginning level"	11
(どうわ)	童話	"children's story, fairy tale"	12
(しんねん)	新年	"new year"	9
(ぜんしん)	全身	"whole body, entire body"	8
(こごえ)	小声	"low voice, whisper"	7
(ひだりがわ)	左側	"left side"	17
(ほそい)	細い	"thin, slender"	17
(じょうしき)	常識	"common sense, common knowledge"	17
(かける)	欠ける	"to lack, to be lacking, to be chipped"	7
(そこ)	底	"bottom"	17
(むごん)	無言	"silence"	17
(むり)	無理	"impossible, unreasonable, overdoing"	17
(れんあい)	恋愛	"love, romance"	17
(ひがしがわ)	東側	"east side"	17
(にしがわ)	西側	"west side"	17
(じてん)	辞典	"dictionary, lexicon"	16
(せいふ)	政府	"government"	16
(はじまる)	始まる	"to begin, something begins, to start, something starts"	9
(おもしろい)	面白い	"interesting, amusing, funny"	16
(けんちくか)	建築家	"architect"	17
(じしん)	自信	"confidence, self confidence"	15
(きこえる)	聞こえる	"hearable, audible, to be able to hear, to be heard, to be audible, can hear"	12
(しゅい)	主位	"leading person, first place, leading position, first position, head position"	11
(きげんぜん)	紀元前	"before christ, bc, bce, before common era"	17
(こい)	恋	"love"	17
(しつれん)	失恋	"heartbreak, broken heart"	17
(まぼろし)	幻	"illusion, phantom"	17
(げんそう)	幻想	"fantasy, illusion"	17
(はてる)	果てる	"to end, to be finished, to be exhausted, to die"	17
(くだもの)	果物	"fruit"	17
(かんする)	関する	"to be connected to, to be related"	16
(はなくそ)	鼻くそ	"snot, boogers"	17
(はなぢ, はなじ)	鼻血	"nosebleed, bloody nose"	17
(はな)	鼻	"nose"	17
(けっせき)	欠席	"absence, nonattendance"	17
(しゅっせき)	出席	"attendance"	17
(かわぞこ)	川底	"riverbed, river bottom"	17
(しんそこ)	心底	"bottom of one's heart, bottom of my heart"	17
(せき)	席	"seat"	17
(げんさく)	原作	"original work"	17
(げんし)	原子	"atom"	17
(せいよう)	西洋	"the west, western countries"	11
(かんしょう)	干渉	"interference, intervention"	17
(ほす)	干す	"to dry"	17
(ねんじ)	年次	"annual, yearly"	6
(あいかわらず)	相変わらず	"as usual, as ever, the same, as before"	17
(わざ)	技	"technique, art"	14
(べいへい)	米兵	"us soldier, american soldier"	17
(へいき)	兵器	"arms, weapons"	17
(へいいん)	兵員	"military personnel, military strength"	17
(すいへい)	水兵	"navy soldier, naval soldier, seaman"	17
(へい)	兵	"soldier, army, troops"	17
(しりつ)	私立	"private"	14
(きんたま)	金玉	"testicles"	5
(こてんてき)	古典的	"classical"	16
(たいする)	対する	"to compare to, to face each other, to oppose, to compare, to contrast, to contrast to"	8
(さら)	皿	"plate, dish"	4
(うめしゅ)	梅酒	"ume wine, plum wine, plum liquor, umeshu"	17
(むこう)	向こう	"over there, opposite side, other side, far away"	8
(しんゆう)	親友	"close friend, best friend, good friend"	10
(やすみ)	休み	"rest, break, vacation, holiday"	4
(かかわる)	係わる	"to be involved with, to be connected with, to be affected, to have to do with"	16
(しょうひん)	商品	"merchandise"	16
(くさ)	草	"grass"	5
(とうきょうべん)	東京弁	"tokyo dialect"	16
(こうしょう)	交渉	"negotiation"	17
(のぞむ)	望む	"to wish, to desire, to wish for"	14
(しょうにん)	商人	"merchant, trader, shopkeeper"	12
(たいふう)	台風	"typhoon, hurricane"	7
(ないいん)	内因	"internal cause, actual reason"	17
(あくいんあっか)	悪因悪果	"evil breeds evil, evil begets evil"	17
(げんいん)	原因	"cause, origin, source"	17
(しゅいん)	主因	"main cause, primary cause"	17
(しょめい)	署名	"signature"	17
(しおあじ)	塩味	"salty taste, tastes salty, salty, salty flavor"	17
(しお)	塩	"salt"	17
(なんかい)	何回	"how many times"	5
(かがみ)	鏡	"mirror"	13
(あか)	赤	"red"	4
(かざん)	火山	"volcano"	2
(うごかす)	動かす	"to move something"	14
(き)	気	"spirit, energy"	4
(しおみず)	塩水	"salt water"	17
(どりょく)	努力	"great effort, exertion, grueling effort"	11
(うめ)	梅	"ume, japanese plum"	17
(かかす)	欠かす	"to miss, to fail, to fail to attend"	9
(ちあん)	治安	"public order, public safety, public peace"	16
(あわせる)	合わせる	"to join together, to unify together, to unite, to match, to unify, to bring together, to join"	11
(きゅうじん)	求人	"help wanted, seeking workers"	14
(にん)	〜人	"number of people, people, people counter, counter for people"	3
(はやい)	速い	"fast"	10
(かんしん)	感心	"admiration"	13
(へんじ)	変事	"strange incident, unusual incident"	15
(じじょう)	事情	"circumstances, reason, situation"	13
(あらそう)	争う	"to compete, to argue, to quarrel"	11
(ぜひ)	是非	"absolutely, by all means"	17
(いしき)	意識	"awareness, consciousness"	17
(ちしき)	知識	"knowledge, information"	17
(けむし)	毛虫	"caterpillar"	5
(ぐあい)	具合	"condition, health"	9
(しゅっぱつ)	出発	"departure"	9
(かんきん)	官金	"government funds, government money"	17
(がいこうかん)	外交官	"diplomat"	17
(しっぱい)	失敗	"failure, mistake"	17
(しょうはい)	勝敗	"victory or defeat, win or lose"	17
(はいしゃ)	敗者	"loser, the defeated"	17
(かえす)	返す	"to return, to return something"	9
(しょうせつ)	小説	"novel"	17
(かせつ)	仮説	"hypothesis"	17
(ずせつ)	図説	"illustration, explanatory diagram"	17
(けっか)	結果	"result"	17
(けっきょく)	結局	"after all, eventually, in the end"	17
(しょくどう)	食堂	"cafeteria, dining hall"	17
(きえる)	消える	"to disappear, to go out, to turn off"	14
(かんかく)	感覚	"senses, the senses"	17
(やぶれる)	敗れる	"to be defeated, to be unsuccessful"	17
(ひん, しな)	品	"article, item, goods"	16
(でんせつ)	伝説	"legend"	17
(こんげつ)	今月	"this month, current month"	3
(にゅうじょう)	入場	"entrance, admission, entering"	8
(ほうほう)	方法	"method, way"	15
(あいちけん)	愛知県	"aichi prefecture"	17
(まえ)	前	"front, before"	6
(うしろ)	後ろ	"behind, back, rear"	6
(やくにたつ)	役に立つ	"to be useful, to be of use, to be helpful, to be of service"	8
(ようもう)	羊毛	"wool"	6
(やくよう)	薬用	"medicinal, medicinal use"	17
(けいかく)	計画	"plan"	15
(じょうぶ)	丈夫	"sturdy, firm"	15
(うつす)	映す	"to project, to reflect"	15
(さつじんしゃ)	殺人者	"murderer, killer"	15
(のこり)	残り	"remainder, remnant, leftover, residue"	14
(しゅうりょう)	終了	"end, finish, close"	10
(のみもの)	飲み物	"beverage, drink"	12
(ちゅうもんする)	注文する	"to order, to request"	13
(まいる)	参る	"to come, to go"	14
(じかく)	自覚	"consciousness, awareness, realization"	17
(がわ, そば)	側	"side, side of something, part"	17
(ほじ)	保持	"retention, maintenance, preservation"	16
(へいし)	兵士	"soldier"	17
(ぶじ)	無事	"safe and sound, safe"	17
(であう)	出会う	"to meet by chance, to meet unexpectedly, to come across, to encounter, to run into"	10
(さけずき)	酒好き	"drinker, alcoholic"	13
(にわ)	庭	"garden, yard"	12
(じょげん)	助言	"advice"	8
(みかた)	味方	"ally, supporter, friend"	11
(あつまり)	集まり	"gathering, meeting, assembly, party, collection, get together"	12
(かなしむ)	悲しむ	"to be sad"	14
(じょうねつ)	情熱	"passion, enthusiasm"	13
(おこす)	起こす	"to wake someone up, to wake up, to wake someone"	14
(きょえいしん)	虚栄心	"vanity"	17
(むなしい)	虚しい	"empty, vacant, futile, vain"	17
(おおきさ)	大きさ	"size"	1
(いち)	一	"one"	1
(こくみん)	国民	"the people, citizens, national"	7
(あいだ, ま)	間	"interval, interval of time, time interval, between, room"	8
(あい)	愛	"love"	17
(まず)	先ず	"first of all, to start with, firstly, to begin with"	4
(やめる)	辞める	"to quit, to resign"	16
(むめい)	無名	"anonymous"	17
(もとめる)	求める	"to want, to request, to demand"	14
(はなうた)	鼻歌	"humming"	17
(かんせい)	完成	"completion, accomplishment"	14
(なかま)	仲間	"companion, comrade, associate"	11
(はがき)	葉書	"postcard"	18
(とりわけ)	取り分け	"especially"	18
(こもりうた)	子守歌	"lullaby"	18
(ごがつ)	五月	"may"	2
(せつめい)	説明	"explanation"	17
(あいじょう)	愛情	"love, affection"	17
(すむ)	住む	"to live, to dwell, to reside"	8
(ぎのう)	技能	"skill, ability"	14
(げんかく)	幻覚	"hallucination"	17
(そうてい)	想定	"hypothesis, supposition, assumption, estimation"	13
(じしょけい)	辞書形	"dictionary form"	18
(せいあい)	性愛	"sexual love"	17
(かきなおす)	書き直す	"to rewrite"	18
(はなさき)	鼻先	"tip of the nose, tip of nose, nose tip"	17
(かっき)	活気	"energy, liveliness, vigor, spirit"	6
(きょじゃく)	虚弱	"weak, feeble, weakness, feebleness"	17
(きりとる)	切り取る	"to cut off, to cut out"	18
(とりきめ)	取り決め	"arrangement, agreement"	18
(たてもの)	建物	"building"	17
(こうこく)	広告	"advertisement, ad, advert"	18
(ひとしい)	等しい	"equal, similar, equivalent"	18
(こくはく)	告白	"confession"	18
(きねん)	祈念	"prayer, a prayer"	18
(ざぜん)	座禅	"zen meditation"	18
(へいせい)	平静	"calm, serene, tranquil"	18
(しゃくよう)	借用	"borrowing, loan"	18
(のう)	脳	"brain"	18
(つげる)	告げる	"to announce, to tell"	18
(じょうほう)	情報	"information, data"	18
(しょるい)	書類	"document"	18
(きょうくん)	教訓	"lesson, moral"	18
(しずか)	静か	"quiet"	18
(ゆるす)	許す	"to permit, to forgive, to allow"	18
(せんしゃ)	洗車	"car wash"	18
(じゅけん)	受験	"take an exam, take an examination, take a test, taking an exam, taking an examination, taking a test"	18
(ほうこく)	報告	"report, information"	18
(たっする)	達する	"to attain, to reach, to get to, to arrive at"	18
(ぜんそう)	禅僧	"zen priest"	18
(まい)	〜枚	"flat object, clothing items, sheets, flat object counter"	18
(もんく)	文句	"complaint"	18
(やきとり)	焼き鳥	"roast chicken, cooked chicken, yakitori"	18
(せんれん)	洗練	"refinement, polish"	18
(よこく)	予告	"advance notice, forward notice, prior notice"	18
(のうし)	脳死	"brain death, brain dead"	18
(よほう)	予報	"forecast"	18
(しけん)	試験	"examination, test, experiment, exam"	18
(きんじる)	禁じる	"to prohibit"	18
(ししょく)	試食	"sample, taste, food sample"	18
(ふかけつ)	不可欠	"indispensable, essential"	18
(かのう)	可能	"possible"	18
(あらう)	洗う	"to wash"	18
(すわる)	座る	"to sit"	18
(いのる)	祈る	"to pray"	18
(むね)	胸	"chest, breasts"	18
(ともだち)	友達	"friend, companion"	18
(じっけん)	実験	"experiment"	18
(かわいい)	可愛い	"cute"	18
(ふとう)	不等	"inequality, disparity"	18
(きょか)	許可	"permission"	18
(きゅうどう)	弓道	"archery, kyudo, kyuudou"	18
(なんまい)	何枚	"how many flat objects, how many sheets"	18
(はいたつする)	配達する	"to deliver"	18
(しゃくや, しゃっか)	借家	"renting a house, house for rent, rented house"	18
(こうこく)	公告	"public notice, public announcement"	18
(こうとう)	高等	"high class, high grade"	18
(わすれる)	忘れる	"to forget"	18
(ほうどう)	報道	"news report"	18
(ぎんざ)	銀座	"ginza"	18
(たち)	〜達	"pluralizing suffix, pluralising suffix"	18
(かぶん)	可分	"divisible, separable"	18
(きんく)	禁句	"taboo word, taboo phrase, dirty word, bad word"	18
(ゆみ)	弓	"bow"	18
(やきにく)	焼き肉	"roast meat, grilled meat, cooked meat, yakiniku"	18
(のうみそ)	脳みそ	"brains, gray matter"	18
(ひやけ)	日焼け	"sunburn, suntan, tan"	18
(きつえん)	喫煙	"smoking"	18
(ぶっそう)	仏僧	"buddhist priest"	18
(ぼうねんかい)	忘年会	"year end party, end of year party"	18
(ごまい)	五枚	"five flat objects, five sheets"	18
(きがん)	祈願	"prayer, a prayer"	18
(せんのう)	洗脳	"brainwashing"	18
(せいざ)	正座	"seiza, traditional japanese sitting"	18
(ほうじる)	報じる	"to report on"	18
(ゆうやけ)	夕焼け	"sunset"	18
(たつじん)	達人	"master, expert"	18
(じんるい)	人類	"mankind, race of people, humanity, humankind"	18
(きしゃ)	汽車	"steam train, steam engine train, steam engine"	18
(きんえん)	禁煙	"no smoking"	18
(とうごう)	等号	"equal sign, equals sign"	18
(しゅるい)	種類	"kind, type"	18
(そういん)	僧院	"temple, monastery"	18
(けむり)	煙	"smoke"	18
(かりる)	借りる	"to borrow"	18
(しゃっきん)	借金	"debt"	18
(くんれん)	訓練	"training"	18
(くんよみ)	訓読み	"kun'yomi, kun reading, japanese reading"	18
(こくえん)	黒煙	"black smoke"	18
(たいとう)	対等	"equality, equal"	18
(きっさてん)	喫茶店	"tea house, cafe, coffee house, coffee shop"	18
(ぜんでら, ぜんじ)	禅寺	"zen temple"	18
(ざせき)	座席	"seat"	18
(きせん)	汽船	"steam ship, steam boat"	18
(でんたつ)	伝達	"transmission, transmit, convey"	18
(ぶんるい)	分類	"classification"	18
(きんし)	禁止	"forbidden, prohibition, ban"	18
(ためす)	試す	"to attempt, to try out, to test, to test the limits, to try"	18
(こころみる)	試みる	"to try, to attempt"	18
(いっとう)	一等	"first class, first rank, the best"	18
(じんしゅ)	人種	"race of people, race"	18
(やく)	焼く	"to bake, to cook, to grill, to burn, to fry"	18
(しあい)	試合	"game, match"	18
(たいけん)	体験	"experience"	18
(まいすう)	枚数	"number of sheets, number of flat objects"	18
(けいこく)	警告	"warning, advice, caution"	18
(しんるい)	親類	"relatives"	18
(せいし)	静止	"still, standstill, at rest, stationary"	18
